N,Z,A,Sym,Mass,Excess
1,0,1, n,1,8664.91574
0,1,1,H,1,7825.03207
1,1,2,H,2,14101.77785
2,1,3,H,3,16049.27767
1,2,3,He,3,16029.31914
0,3,3,Li,3,30775
3,1,4,H,4,27806.424
2,2,4,He,4,2603.25415
1,3,4,Li,4,27185.558
4,1,5,H,5,35311.488
3,2,5,He,5,12223.624
2,3,5,Li,5,12537.8
1,4,5,Be,5,40790
5,1,6,H,6,44942.594
4,2,6,He,6,18889.124
3,3,6,Li,6,15122.794
2,4,6,Be,6,19726.317
1,5,6,B,6,46810
6,1,7,H,7,52749
5,2,7,He,7,28020.618
4,3,7,Li,7,16004.548
3,4,7,Be,7,16929.828
2,5,7,B,7,29917.901
6,2,8,He,8,33921.897
5,3,8,Li,8,22487.362
4,4,8,Be,8,5305.103
3,5,8,B,8,24607.233
2,6,8,C,8,37675.025
7,2,9,He,9,43950.286
6,3,9,Li,9,26789.505
5,4,9,Be,9,12182.201
4,5,9,B,9,13328.782
3,6,9,C,9,31036.689
8,2,10,He,10,52398.837
7,3,10,Li,10,35481.259
6,4,10,Be,10,13533.818
5,5,10,B,10,12936.992
4,6,10,C,10,16853.228
3,7,10,N,10,41653.674
8,3,11,Li,11,43797.715
7,4,11,Be,11,21657.749
6,5,11,B,11,9305.406
5,6,11,C,11,11433.613
4,7,11,N,11,26090.956
9,3,12,Li,12,53780
8,4,12,Be,12,26920.737
7,5,12,B,12,14352.104
6,6,12,C,12,0
5,7,12,N,12,18613.197
4,8,12,O,12,34404.895
9,4,13,Be,13,35693.007
8,5,13,B,13,17780.217
7,6,13,C,13,3354.83778
6,7,13,N,13,5738.609
5,8,13,O,13,24812.213
10,4,14,Be,14,42892.92
9,5,14,B,14,25404.009
8,6,14,C,14,3241.9887
7,7,14,N,14,3074.00478
6,8,14,O,14,8596.25
5,9,14,F,14,35060
11,4,15,Be,15,53460
10,5,15,B,15,31103.021
9,6,15,C,15,10599.256
8,7,15,N,15,108.89823
7,8,15,O,15,3065.617
6,9,15,F,15,18009.103
12,4,16,Be,16,61920
11,5,16,B,16,39808.829
10,6,16,C,16,14701.252
9,7,16,N,16,6101.658
8,8,16,O,15,994914.61956
7,9,16,F,16,11465.724
6,10,16,Ne,16,25761.262
12,5,17,B,17,46989.906
11,6,17,C,17,22586.116
10,7,17,N,17,8450.261
9,8,17,O,16,999131.703
8,9,17,F,17,2095.237
7,10,17,Ne,17,17671.504
13,5,18,B,18,56170
12,6,18,C,18,26759.354
11,7,18,N,18,14078.959
10,8,18,O,17,999161.001
9,9,18,F,18,937.956
8,10,18,Ne,18,5708.213
7,11,18,Na,18,25969
14,5,19,B,19,63730
13,6,19,C,19,34805.018
12,7,19,N,19,17028.697
11,8,19,O,19,3580.13
10,9,19,F,18,998403.224
9,10,19,Ne,19,1880.248
8,11,19,Na,19,13877.499
7,12,19,Mg,19,35470
14,6,20,C,20,40319.754
13,7,20,N,20,23365.807
12,8,20,O,20,4076.742
11,9,20,F,19,999981.315
10,10,20,Ne,19,992440.17542
9,11,20,Na,20,7351.328
8,12,20,Mg,20,18862.545
15,6,21,C,21,49340
14,7,21,N,21,27108.24
13,8,21,O,21,8655.886
12,9,21,F,20,999948.951
11,10,21,Ne,20,993846.684
10,11,21,Na,20,997655.206
9,12,21,Mg,21,11712.91
8,13,21,Al,21,28040
16,6,22,C,22,57200
15,7,22,N,22,34394.934
14,8,22,O,22,9966.947
13,9,22,F,22,2998.815
12,10,22,Ne,21,991385.113
11,11,22,Na,21,994436.425
10,12,22,Mg,21,999573.843
9,13,22,Al,22,19520
8,14,22,Si,22,34530
16,7,23,N,23,41220
15,8,23,O,23,15687.659
14,9,23,F,23,3574.631
13,10,23,Ne,22,994466.904
12,11,23,Na,22,989769.28087
11,12,23,Mg,22,994123.669
10,13,23,Al,23,7267.432
9,14,23,Si,23,25520
17,7,24,N,24,51040
16,8,24,O,24,20472.917
15,9,24,F,24,8115.485
14,10,24,Ne,23,993610.779
13,11,24,Na,23,990962.782
12,12,24,Mg,23,985041.699
11,13,24,Al,23,999938.865
10,14,24,Si,24,11545.616
9,15,24,P,24,34350
18,7,25,N,25,60660
17,8,25,O,25,29460
16,9,25,F,25,12101.747
15,10,25,Ne,24,997736.888
14,11,25,Na,24,989953.968
13,12,25,Mg,24,985836.917
12,13,25,Al,24,990428.095
11,14,25,Si,25,4105.574
10,15,25,P,25,20260
18,8,26,O,26,38340
17,9,26,F,26,19615.555
16,10,26,Ne,26,461.206
15,11,26,Na,25,992633
14,12,26,Mg,25,982592.929
13,13,26,Al,25,986891.692
12,14,26,Si,25,992329.921
11,15,26,P,26,11780
10,16,26,S,26,27880
19,8,27,O,27,48260
18,9,27,F,27,26760.086
17,10,27,Ne,27,7589.903
16,11,27,Na,26,994076.788
15,12,27,Mg,26,984340.585
14,13,27,Al,26,981538.627
13,14,27,Si,26,986704.905
12,15,27,P,26,999230.236
11,16,27,S,27,18833
20,8,28,O,28,57810
19,9,28,F,28,35670
18,10,28,Ne,28,12071.575
17,11,28,Na,27,998938
16,12,28,Mg,27,983876.825
15,13,28,Al,27,981910.306
14,14,28,Si,27,976926.53246
13,15,28,P,27,992314.761
12,16,28,S,28,4372.763
11,17,28,Cl,28,28510
20,9,29,F,29,43260
19,10,29,Ne,29,19385.933
18,11,29,Na,29,2861
17,12,29,Mg,28,988600
16,13,29,Al,28,980445.046
15,14,29,Si,28,976494.7
14,15,29,P,28,981800.606
13,16,29,S,28,996608.049
12,17,29,Cl,29,14110
21,9,30,F,30,52500
20,10,30,Ne,30,24801.045
19,11,30,Na,30,8976
18,12,30,Mg,29,990434
17,13,30,Al,29,982960.256
16,14,30,Si,29,973770.171
15,15,30,P,29,978313.789
14,16,30,S,29,984903.249
13,17,30,Cl,30,4770
12,18,30,Ar,30,21560
22,9,31,F,31,60429
21,10,31,Ne,31,33110
20,11,31,Na,31,13585.452
19,12,31,Mg,30,996546
18,13,31,Al,30,983946.619
17,14,31,Si,30,975363.227
16,15,31,P,30,973761.629
15,16,31,S,30,979554.728
14,17,31,Cl,30,992413.086
13,18,31,Ar,31,12123
22,10,32,Ne,32,40020
21,11,32,Na,32,20466.56
20,12,32,Mg,31,998975
19,13,32,Al,31,988124.489
18,14,32,Si,31,974148.082
17,15,32,P,31,973907.274
16,16,32,S,31,972070.999
15,17,32,Cl,31,985689.901
14,18,32,Ar,31,997637.984
13,19,32,K,32,21920
23,10,33,Ne,33,49380
22,11,33,Na,33,26719.756
21,12,33,Mg,33,5254
20,13,33,Al,32,990843.336
19,14,33,Si,32,978000.22
18,15,33,P,32,971725.543
17,16,33,S,32,971458.759
16,17,33,Cl,32,977451.887
15,18,33,Ar,32,989925.709
14,19,33,K,33,7260
24,10,34,Ne,34,57028
23,11,34,Na,34,35170
22,12,34,Mg,34,9456.424
21,13,34,Al,33,996851.837
20,14,34,Si,33,978575.524
19,15,34,P,33,973636.257
18,16,34,S,33,967866.902
17,17,34,Cl,33,973762.819
16,18,34,Ar,33,980271.244
15,19,34,K,33,998410
14,20,34,Ca,34,14120
24,11,35,Na,35,42493
23,12,35,Mg,35,17340
22,13,35,Al,34,999860.235
21,14,35,Si,34,984583.575
20,15,35,P,34,973314.117
19,16,35,S,34,969032.161
18,17,35,Cl,34,968852.682
17,18,35,Ar,34,975257.585
16,19,35,K,34,988009.692
15,20,35,Ca,35,4940
25,11,36,Na,36,51480
24,12,36,Mg,36,23000
23,13,36,Al,36,6207.204
22,14,36,Si,35,986599.477
21,15,36,P,35,978259.68
20,16,36,S,35,967080.76
19,17,36,Cl,35,968306.981
18,18,36,Ar,35,967545.105
17,19,36,K,35,981292.235
16,20,36,Ca,35,993087.063
15,21,36,Sc,36,14920
26,11,37,Na,37,59340
25,12,37,Mg,37,31400
24,13,37,Al,37,10677.82
23,14,37,Si,36,992936.08
22,15,37,P,36,979608.946
21,16,37,S,36,971125.567
20,17,37,Cl,36,965902.591
19,18,37,Ar,36,966776.32
18,19,37,K,36,973375.889
17,20,37,Ca,36,985870.269
16,21,37,Sc,37,3050
26,12,38,Mg,38,37570
25,13,38,Al,38,17231.021
24,14,38,Si,37,995633.601
23,15,38,P,37,984156.827
22,16,38,S,37,971163.317
21,17,38,Cl,37,968010.425
20,18,38,Ar,37,962732.394
19,19,38,K,37,969081.184
18,20,38,Ca,37,976318.452
17,21,38,Sc,37,994700
16,22,38,Ti,38,9770
27,12,39,Mg,39,46772
26,13,39,Al,39,22970
25,14,39,Si,39,2070.013
24,15,39,P,38,986179.475
23,16,39,S,38,975134.306
22,17,39,Cl,38,968008.164
21,18,39,Ar,38,964313.231
20,19,39,K,38,963706.679
19,20,39,Ca,38,970719.725
18,21,39,Sc,38,984790.002
17,22,39,Ti,39,1610
28,12,40,Mg,40,53930
27,13,40,Al,40,31450
26,14,40,Si,40,5869.121
25,15,40,P,39,991296.951
24,16,40,S,39,975451.728
23,17,40,Cl,39,970415.472
22,18,40,Ar,39,962383.12251
21,19,40,K,39,963998.475
20,20,40,Ca,39,962590.983
19,21,40,Sc,39,977967.407
18,22,40,Ti,39,990498.838
17,23,40,V,40,11090
28,13,41,Al,41,38330
27,14,41,Si,41,14560
26,15,41,P,40,994335.435
25,16,41,S,40,979582.149
24,17,41,Cl,40,970684.525
23,18,41,Ar,40,964500.611
22,19,41,K,40,961825.762
21,20,41,Ca,40,962278.062
20,21,41,Sc,40,969251.125
19,22,41,Ti,40,983145
18,23,41,V,40,999780
29,13,42,Al,42,46890
28,14,42,Si,42,19790
27,15,42,P,42,1007.913
26,16,42,S,41,981022.419
25,17,42,Cl,41,973254.804
24,18,42,Ar,41,963045.736
23,19,42,K,41,962402.81
22,20,42,Ca,41,958618.014
21,21,42,Sc,41,965516.429
20,22,42,Ti,41,973030.902
19,23,42,V,41,991230
18,24,42,Cr,42,6430
29,14,43,Si,43,28660
28,15,43,P,43,6190
27,16,43,S,42,987154.79
26,17,43,Cl,42,974054.403
25,18,43,Ar,42,965636.056
24,19,43,K,42,960715.54
23,20,43,Ca,42,958766.628
22,21,43,Sc,42,961150.658
21,22,43,Ti,42,968522.499
20,23,43,V,42,980650
19,24,43,Cr,42,997710
30,14,44,Si,44,35260
29,15,44,P,44,12990
28,16,44,S,43,990213.39
27,17,44,Cl,43,978281.071
26,18,44,Ar,43,964924.033
25,19,44,K,43,961556.804
24,20,44,Ca,43,955481.754
23,21,44,Sc,43,959402.752
22,22,44,Ti,43,959690.069
21,23,44,V,43,974110
20,24,44,Cr,43,985549
19,25,44,Mn,44,6870
30,15,45,P,45,19220
29,16,45,S,44,996508.112
28,17,45,Cl,44,980286.886
27,18,45,Ar,44,968039.956
26,19,45,K,44,960699.493
25,20,45,Ca,44,956186.566
24,21,45,Sc,44,955911.909
23,22,45,Ti,44,958125.616
22,23,45,V,44,965775.808
21,24,45,Cr,44,979640
20,25,45,Mn,44,994510
19,26,45,Fe,45,14578
31,15,46,P,46,27380
30,16,46,S,46,750
29,17,46,Cl,45,984210.04
28,18,46,Ar,45,968094.129
27,19,46,K,45,961976.864
26,20,46,Ca,45,953692.587
25,21,46,Sc,45,955171.89
24,22,46,Ti,45,952631.555
23,23,46,V,45,960200.481
22,24,46,Cr,45,968358.635
21,25,46,Mn,45,986720
20,26,46,Fe,46,810
31,16,47,S,47,8590
30,17,47,Cl,46,988710
29,18,47,Ar,46,972186.792
28,19,47,K,46,961678.473
27,20,47,Ca,46,954546.006
26,21,47,Sc,46,952407.508
25,22,47,Ti,46,951763.088
24,23,47,V,46,954908.94
23,24,47,Cr,46,962900.046
22,25,47,Mn,46,976100
21,26,47,Fe,46,992890
20,27,47,Co,47,11490
32,16,48,S,48,14170
31,17,48,Cl,47,994950
30,18,48,Ar,47,974540
29,19,48,K,47,965513.535
28,20,48,Ca,47,952534.177
27,21,48,Sc,47,952231.468
26,22,48,Ti,47,947946.281
25,23,48,V,47,952253.707
24,24,48,Cr,47,954031.716
23,25,48,Mn,47,968520
22,26,48,Fe,47,980504
21,27,48,Co,48,1760
20,28,48,Ni,48,19750
33,16,49,S,49,23619
32,17,49,Cl,49,320
31,18,49,Ar,48,980520
30,19,49,K,48,967450.928
29,20,49,Ca,48,955674.148
28,21,49,Sc,48,950023.975
27,22,49,Ti,48,947869.982
26,23,49,V,48,948516.101
25,24,49,Cr,48,951335.721
24,25,49,Mn,48,959618.005
23,26,49,Fe,48,973610
22,27,49,Co,48,989720
21,28,49,Ni,49,9660
33,17,50,Cl,50,7840
32,18,50,Ar,49,984430
31,19,50,K,49,972783.355
30,20,50,Ca,49,957518.962
29,21,50,Sc,49,952187.685
28,22,50,Ti,49,944791.194
27,23,50,V,49,947158.485
26,24,50,Cr,49,946044.205
25,25,50,Mn,49,954238.23
24,26,50,Fe,49,962988.982
23,27,50,Co,49,981540
22,28,50,Ni,49,995930
34,17,51,Cl,51,14490
33,18,51,Ar,50,991630
32,19,51,K,50,976380
31,20,51,Ca,50,961499.214
30,21,51,Sc,50,953603.368
29,22,51,Ti,50,946614.955
28,23,51,V,50,943959.507
27,24,51,Cr,50,944767.431
26,25,51,Mn,50,948210.787
25,26,51,Fe,50,956819.538
24,27,51,Co,50,970720
23,28,51,Ni,50,987720
34,18,52,Ar,51,996780
33,19,52,K,51,982610
32,20,52,Ca,51,965100
31,21,52,Sc,51,956675.468
30,22,52,Ti,51,946897.311
29,23,52,V,51,944775.479
28,24,52,Cr,51,940507.472
27,25,52,Mn,51,945565.464
26,26,52,Fe,51,948113.875
25,27,52,Co,51,963590
24,28,52,Ni,51,975680
23,29,52,Cu,51,997180
35,18,53,Ar,53,4940
34,19,53,K,52,987120
33,20,53,Ca,52,970050
32,21,53,Sc,52,959610
31,22,53,Ti,52,949727.171
30,23,53,V,52,944337.979
29,24,53,Cr,52,940649.386
28,25,53,Mn,52,941290.117
27,26,53,Fe,52,945307.942
26,27,53,Co,52,954218.896
25,28,53,Ni,52,968470
24,29,53,Cu,52,985550
35,19,54,K,53,994200
34,20,54,Ca,53,974350
33,21,54,Sc,53,963264.561
32,22,54,Ti,53,951052.401
31,23,54,V,53,946439.854
30,24,54,Cr,53,938880.395
29,25,54,Mn,53,940358.854
28,26,54,Fe,53,939610.501
27,27,54,Co,53,948459.635
26,28,54,Ni,53,957905.495
25,29,54,Cu,53,976710
24,30,54,Zn,53,992950
36,19,55,K,54,999710
35,20,55,Ca,54,980550
34,21,55,Sc,54,968243.949
33,22,55,Ti,54,955265.056
32,23,55,V,54,947233.701
31,24,55,Cr,54,940839.672
30,25,55,Mn,54,938045.141
29,26,55,Fe,54,938293.357
28,27,55,Co,54,941999.029
27,28,55,Ni,54,951330.251
26,29,55,Cu,54,966050
25,30,55,Zn,54,983980
36,20,56,Ca,55,985570
35,21,56,Sc,55,972870
34,22,56,Ti,55,958199.639
33,23,56,V,55,950530.966
32,24,56,Cr,55,940653.139
31,25,56,Mn,55,938904.91
30,26,56,Fe,55,934937.475
29,27,56,Co,55,939839.278
28,28,56,Ni,55,942132.022
27,29,56,Cu,55,958560
26,30,56,Zn,55,972380
25,31,56,Ga,55,994910
37,20,57,Ca,56,992356
36,21,57,Sc,56,977790
35,22,57,Ti,56,963989.137
34,23,57,V,56,952561.432
33,24,57,Cr,56,943613.013
32,25,57,Mn,56,938285.378
31,26,57,Fe,56,935393.969
30,27,57,Co,56,936291.373
29,28,57,Ni,56,939793.526
28,29,57,Cu,56,949211.078
27,30,57,Zn,56,964788
26,31,57,Ga,56,982930
37,21,58,Sc,57,983710
36,22,58,Ti,57,966970
35,23,58,V,57,956834.136
34,24,58,Cr,57,944353.129
33,25,58,Mn,57,939981.549
32,26,58,Fe,57,933275.558
31,27,58,Co,57,935752.814
30,28,58,Ni,57,935342.907
29,29,58,Cu,57,944538.499
28,30,58,Zn,57,954591.555
27,31,58,Ga,57,974250
26,32,58,Ge,57,991010
38,21,59,Sc,58,989220
37,22,59,Ti,58,972930
36,23,59,V,58,960207.407
35,24,59,Cr,58,948586.367
34,25,59,Mn,58,940440.237
33,26,59,Fe,58,934875.464
32,27,59,Co,58,933195.048
31,28,59,Ni,58,934346.705
30,29,59,Cu,58,939498.028
29,30,59,Zn,58,949263.764
28,31,59,Ga,58,963370
27,32,59,Ge,58,981750
39,21,60,Sc,59,995710
38,22,60,Ti,59,976760
37,23,60,V,59,965026.862
36,24,60,Cr,59,950076.033
35,25,60,Mn,59,942911.246
34,26,60,Fe,59,934071.683
33,27,60,Co,59,933817.059
32,28,60,Ni,59,930786.372
31,29,60,Cu,59,937365.03
30,30,60,Zn,59,941827.035
29,31,60,Ga,59,957060
28,32,60,Ge,59,970190
27,33,60,As,59,993130
39,22,61,Ti,60,983200
38,23,61,V,60,968480
37,24,61,Cr,60,954717.204
36,25,61,Mn,60,944652.638
35,26,61,Fe,60,936745.281
34,27,61,Co,60,932475.763
33,28,61,Ni,60,931056.033
32,29,61,Cu,60,933457.821
31,30,61,Zn,60,939510.635
30,31,61,Ga,60,949446.287
29,32,61,Ge,60,963790
28,33,61,As,60,980620
40,22,62,Ti,61,987490
39,23,62,V,61,973780
38,24,62,Cr,61,956613.19
37,25,62,Mn,61,948428.22
36,26,62,Fe,61,936767.442
35,27,62,Co,61,934050.563
34,28,62,Ni,61,928345.115
33,29,62,Cu,61,932583.745
32,30,62,Zn,61,934329.764
31,31,62,Ga,61,944175.238
30,32,62,Ge,61,954650
29,33,62,As,61,973200
41,22,63,Ti,62,994420
40,23,63,V,62,977550
39,24,63,Cr,62,961860
38,25,63,Mn,62,950239.99
37,26,63,Fe,62,940369.091
36,27,63,Co,62,933611.611
35,28,63,Ni,62,929669.374
34,29,63,Cu,62,929597.474
33,30,63,Zn,62,933211.566
32,31,63,Ga,62,939294.196
31,32,63,Ge,62,949640
30,33,63,As,62,963690
41,23,64,V,63,983470
40,24,64,Cr,63,964410
39,25,64,Mn,63,954249.09
38,26,64,Fe,63,941201.265
37,27,64,Co,63,935809.908
36,28,64,Ni,63,927965.959
35,29,64,Cu,63,929764.183
34,30,64,Zn,63,929142.222
33,31,64,Ga,63,936838.747
32,32,64,Ge,63,941653
31,33,64,As,63,957572
42,23,65,V,64,987920
41,24,65,Cr,64,970160
40,25,65,Mn,64,956336.065
39,26,65,Fe,64,945380.27
38,27,65,Co,64,936478.46
37,28,65,Ni,64,930084.304
36,29,65,Cu,64,927789.485
35,30,65,Zn,64,929240.984
34,31,65,Ga,64,932734.754
33,32,65,Ge,64,939436.406
32,33,65,As,64,949564
31,34,65,Se,64,964660
42,24,66,Cr,65,973380
41,25,66,Mn,65,961080
40,26,66,Fe,65,946780.638
39,27,66,Co,65,939762.004
38,28,66,Ni,65,929139.334
37,29,66,Cu,65,928868.813
36,30,66,Zn,65,926033.419
35,31,66,Ga,65,931589.01
34,32,66,Ge,65,933843.453
33,33,66,As,65,944710
32,34,66,Se,65,955210
43,24,67,Cr,66,979550
42,25,67,Mn,66,964140
41,26,67,Fe,66,950947.244
40,27,67,Co,66,940889.529
39,28,67,Ni,66,931569.414
38,29,67,Cu,66,927730.314
37,30,67,Zn,66,927127.345
36,31,67,Ga,66,928201.703
35,32,67,Ge,66,932734.07
34,33,67,As,66,939186.071
33,34,67,Se,66,950090
32,35,67,Br,66,964790
43,25,68,Mn,67,969300
42,26,68,Fe,67,953700
41,27,68,Co,67,944873.058
40,28,68,Ni,67,931868.789
39,29,68,Cu,67,929610.889
38,30,68,Zn,67,924844.154
37,31,68,Ga,67,927980.084
36,32,68,Ge,67,928094.24
35,33,68,As,67,936769.069
34,34,68,Se,67,941798
33,35,68,Br,67,958516
44,25,69,Mn,68,972840
43,26,69,Fe,68,958780
42,27,69,Co,68,946320
41,28,69,Ni,68,935610.269
40,29,69,Cu,68,929429.269
39,30,69,Zn,68,926550.281
38,31,69,Ga,68,925573.587
37,32,69,Ge,68,927964.533
36,33,69,As,68,932273.675
35,34,69,Se,68,939557.817
34,35,69,Br,68,950106
33,36,69,Kr,68,965180
44,26,70,Fe,69,961460
43,27,70,Co,69,951000
42,28,70,Ni,69,936500
41,29,70,Cu,69,932392.343
40,30,70,Zn,69,925319.274
39,31,70,Ga,69,926021.972
38,32,70,Ge,69,924247.381
37,33,70,As,69,930924.826
36,34,70,Se,69,933390.644
35,35,70,Br,69,944792
34,36,70,Kr,69,955259
45,26,71,Fe,70,966720
44,27,71,Co,70,952900
43,28,71,Ni,70,940736.283
42,29,71,Cu,70,932676.833
41,30,71,Zn,70,927721.599
40,31,71,Ga,70,924701.349
39,32,71,Ge,70,924950.954
38,33,71,As,70,927112.428
37,34,71,Se,70,932241.822
36,35,71,Br,70,938740
35,36,71,Kr,70,949625.738
34,37,71,Rb,70,965320
46,26,72,Fe,71,969620
45,27,72,Co,71,957810
44,28,72,Ni,71,942092.682
43,29,72,Cu,71,935820.307
42,30,72,Zn,71,926857.951
41,31,72,Ga,71,926366.268
40,32,72,Ge,71,922075.815
39,33,72,As,71,926752.283
38,34,72,Se,71,927112.352
37,35,72,Br,71,936644.572
36,36,72,Kr,71,942092.038
35,37,72,Rb,71,959080
46,27,73,Co,72,960240
45,28,73,Ni,72,946470
44,29,73,Cu,72,936675.282
43,30,73,Zn,72,929779.104
42,31,73,Ga,72,925174.682
41,32,73,Ge,72,923458.945
40,33,73,As,72,923824.844
39,34,73,Se,72,926765.345
38,35,73,Br,72,931691.524
37,36,73,Kr,72,939289.195
36,37,73,Rb,72,950561
35,38,73,Sr,72,965970
47,27,74,Co,73,965380
46,28,74,Ni,73,948070
45,29,74,Cu,73,939874.862
44,30,74,Zn,73,929458.609
43,31,74,Ga,73,926945.762
42,32,74,Ge,73,921177.767
41,33,74,As,73,923928.692
40,34,74,Se,73,922476.436
39,35,74,Br,73,929891.034
38,36,74,Kr,73,933084.369
37,37,74,Rb,73,944264.751
36,38,74,Sr,73,956310
48,27,75,Co,74,968330
47,28,75,Ni,74,952870
46,29,75,Cu,74,941900
45,30,75,Zn,74,932936.741
44,31,75,Ga,74,926500.246
43,32,75,Ge,74,922858.948
42,33,75,As,74,921596.478
41,34,75,Se,74,922523.368
40,35,75,Br,74,925776.207
39,36,75,Kr,74,930945.746
38,37,75,Rb,74,938570
37,38,75,Sr,74,949949.568
48,28,76,Ni,75,955330
47,29,76,Cu,75,945275.026
46,30,76,Zn,75,933293.57
45,31,76,Ga,75,928827.626
44,32,76,Ge,75,921402.557
43,33,76,As,75,922394.021
42,34,76,Se,75,919213.597
41,35,76,Br,75,924541.469
40,36,76,Kr,75,925910.078
39,37,76,Rb,75,935072.226
38,38,76,Sr,75,941766.782
37,39,76,Y,75,958450
49,28,77,Ni,76,960550
48,29,77,Cu,76,947850
47,30,77,Zn,76,936958.967
46,31,77,Ga,76,929154.3
45,32,77,Ge,76,923548.591
44,33,77,As,76,920647.286
43,34,77,Se,76,919914.038
42,35,77,Br,76,921379.082
41,36,77,Kr,76,924670
40,37,77,Rb,76,930408
39,38,77,Sr,76,937944.782
38,39,77,Y,76,949645
50,28,78,Ni,77,963180
49,29,78,Cu,77,951960
48,30,78,Zn,77,938440.216
47,31,78,Ga,77,931608.18
46,32,78,Ge,77,922852.739
45,33,78,As,77,921827.281
44,34,78,Se,77,917309.09
43,35,78,Br,77,921145.706
42,36,78,Kr,77,920364.783
41,37,78,Rb,77,928141
40,38,78,Sr,77,932180
39,39,78,Y,77,943610
38,40,78,Zr,77,955230
50,29,79,Cu,78,954560
49,30,79,Zn,78,942652
48,31,79,Ga,78,932893.26
47,32,79,Ge,78,925400.995
46,33,79,As,78,920947.934
45,34,79,Se,78,918499.098
44,35,79,Br,78,918337.087
43,36,79,Kr,78,920082.431
42,37,79,Rb,78,923989.46
41,38,79,Sr,78,929708
40,39,79,Y,78,937351.634
39,40,79,Zr,78,949160
51,29,80,Cu,79,960870
50,30,80,Zn,79,944342.348
49,31,80,Ga,79,936515.781
48,32,80,Ge,79,925372.392
47,33,80,As,79,922533.816
46,34,80,Se,79,916521.271
45,35,80,Br,79,918529.296
44,36,80,Kr,79,916378.965
43,37,80,Rb,79,922519.25
42,38,80,Sr,79,924521.013
41,39,80,Y,79,934280
40,40,80,Zr,79,940400
51,30,81,Zn,80,950480
50,31,81,Ga,80,937752.355
49,32,81,Ge,80,928820.467
48,33,81,As,80,922132.287
47,34,81,Se,80,917992.474
46,35,81,Br,80,916290.563
45,36,81,Kr,80,916592.015
44,37,81,Rb,80,918995.913
43,38,81,Sr,80,923211.846
42,39,81,Y,80,929127.468
41,40,81,Zr,80,937210.026
40,41,81,Nb,80,949030
52,30,82,Zn,81,954420
51,31,82,Ga,81,942990
50,32,82,Ge,81,929549.725
49,33,82,As,81,924504.067
48,34,82,Se,81,916699.401
47,35,82,Br,81,916804.119
46,36,82,Kr,81,913483.6
45,37,82,Rb,81,918208.598
44,38,82,Sr,81,918401.639
43,39,82,Y,81,926792.451
42,40,82,Zr,81,931087
41,41,82,Nb,81,943130
53,30,83,Zn,82,961030
52,31,83,Ga,82,946980
51,32,83,Ge,82,934620
50,33,83,As,82,924980.024
49,34,83,Se,82,919118.473
48,35,83,Br,82,915180.421
47,36,83,Kr,82,914136.099
46,37,83,Rb,82,915109.701
45,38,83,Sr,82,917556.701
44,39,83,Y,82,922354.243
43,40,83,Zr,82,928653.801
42,41,83,Nb,82,936705.382
41,42,83,Mo,82,948740
53,31,84,Ga,83,952650
52,32,84,Ge,83,937470
51,33,84,As,83,929058
50,34,84,Se,83,918462.354
49,35,84,Br,83,916478.974
48,36,84,Kr,83,911506.687
47,37,84,Rb,83,914384.821
46,38,84,Sr,83,913425.275
45,39,84,Y,83,920388.264
44,40,84,Zr,83,923250
43,41,84,Nb,83,933570
42,42,84,Mo,83,940090
54,31,85,Ga,84,957000
53,32,85,Ge,84,943030
52,33,85,As,84,932020
51,34,85,Se,84,922245.053
50,35,85,Br,84,915608.403
49,36,85,Kr,84,912527.331
48,37,85,Rb,84,911789.737
47,38,85,Sr,84,912932.803
46,39,85,Y,84,916433.039
45,40,85,Zr,84,921471.182
44,41,85,Nb,84,927912.447
43,42,85,Mo,84,936550
42,43,85,Tc,84,948830
55,31,86,Ga,85,963120
54,32,86,Ge,85,946490
53,33,86,As,85,936500
52,34,86,Se,85,924271.579
51,35,86,Br,85,918797.577
50,36,86,Kr,85,910610.729
49,37,86,Rb,85,911167.419
48,38,86,Sr,85,909260.204
47,39,86,Y,85,914885.576
46,40,86,Zr,85,916473.591
45,41,86,Nb,85,925038.326
44,42,86,Mo,85,930695.904
43,43,86,Tc,85,942880
55,32,87,Ge,86,952510
54,33,87,As,86,939900
53,34,87,Se,86,928521.358
52,35,87,Br,86,920711.324
51,36,87,Kr,86,913354.862
50,37,87,Rb,86,909180.526
49,38,87,Sr,86,908877.124
48,39,87,Y,86,910875.73
47,40,87,Zr,86,914816.252
46,41,87,Nb,86,920361.108
45,42,87,Mo,86,927326.502
44,43,87,Tc,86,936530
43,44,87,Ru,86,949180
56,32,88,Ge,87,956910
55,33,88,As,87,944940
54,34,88,Se,87,931423.998
53,35,88,Br,87,924065.926
52,36,88,Kr,87,914446.969
51,37,88,Rb,87,911315.588
50,38,88,Sr,87,905612.124
49,39,88,Y,87,909501.146
48,40,88,Zr,87,910226.904
47,41,88,Nb,87,918332.163
46,42,88,Mo,87,921953.241
45,43,88,Tc,87,932678
44,44,88,Ru,87,940260
57,32,89,Ge,88,963830
56,33,89,As,88,949390
55,34,89,Se,88,936450
54,35,89,Br,88,926385.334
53,36,89,Kr,88,917630.581
52,37,89,Rb,88,912278.016
51,38,89,Sr,88,907450.675
50,39,89,Y,88,905848.295
49,40,89,Zr,88,908889.5
48,41,89,Nb,88,913418.245
47,42,89,Mo,88,919480.009
46,43,89,Tc,88,927167
45,44,89,Ru,88,936110
44,45,89,Rh,88,948837
57,33,90,As,89,955500
56,34,90,Se,89,939960
55,35,90,Br,89,930627.737
54,36,90,Kr,89,919516.555
53,37,90,Rb,89,914801.694
52,38,90,Sr,89,907737.888
51,39,90,Y,89,907151.886
50,40,90,Zr,89,904704.416
49,41,90,Nb,89,911264.845
48,42,90,Mo,89,913936.896
47,43,90,Tc,89,923556.564
46,44,90,Ru,89,929890
45,45,90,Rh,89,942870
58,33,91,As,90,960430
57,34,91,Se,90,945960
56,35,91,Br,90,933968.095
55,36,91,Kr,90,923445.215
54,37,91,Rb,90,916536.958
53,38,91,Sr,90,910203.095
52,39,91,Y,90,907304.791
51,40,91,Zr,90,905645.767
50,41,91,Nb,90,906996.243
49,42,91,Mo,90,911750.194
48,43,91,Tc,90,918427.639
47,44,91,Ru,90,926292
46,45,91,Rh,90,936550
45,46,91,Pd,90,949110
59,33,92,As,91,966800
58,34,92,Se,91,949920
57,35,92,Br,91,939258.714
56,36,92,Kr,91,926156.21
55,37,92,Rb,91,919728.9
54,38,92,Sr,91,911037.858
53,39,92,Y,91,908949.143
52,40,92,Zr,91,905040.847
51,41,92,Nb,91,907193.888
50,42,92,Mo,91,906810.991
49,43,92,Tc,91,915260.166
48,44,92,Ru,91,920120
47,45,92,Rh,91,931980
46,46,92,Pd,91,940420
59,34,93,Se,92,956290
58,35,93,Br,92,943050
57,36,93,Kr,92,931274.357
56,37,93,Rb,92,922041.876
55,38,93,Sr,92,914025.634
54,39,93,Y,92,909582.713
53,40,93,Zr,92,906476.006
52,41,93,Nb,92,906378.058
51,42,93,Mo,92,906812.61
50,43,93,Tc,92,910248.984
49,44,93,Ru,92,917052.034
48,45,93,Rh,92,925740
47,46,93,Pd,92,935910
46,47,93,Ag,92,949780
60,34,94,Se,93,960490
59,35,94,Br,93,948680
58,36,94,Kr,93,934360
57,37,94,Rb,93,926404.946
56,38,94,Sr,93,915361.312
55,39,94,Y,93,911595.245
54,40,94,Zr,93,906315.192
53,41,94,Nb,93,907283.888
52,42,94,Mo,93,905088.269
51,43,94,Tc,93,909657.002
50,44,94,Ru,93,911359.711
49,45,94,Rh,93,921698
48,46,94,Pd,93,928770
47,47,94,Ag,93,942780
60,35,95,Br,94,952870
59,36,95,Kr,94,939840
58,37,95,Rb,94,929302.889
57,38,95,Sr,94,919358.766
56,39,95,Y,94,912820.621
55,40,95,Zr,94,908042.6
54,41,95,Nb,94,906835.792
53,42,95,Mo,94,905842.129
52,43,95,Tc,94,907657.084
51,44,95,Ru,94,910412.929
50,45,95,Rh,94,915898.74
49,46,95,Pd,94,924690
48,47,95,Ag,94,935480
47,48,95,Cd,94,949870
61,35,96,Br,95,958530
60,36,96,Kr,95,943070
59,37,96,Rb,95,934272.637
58,38,96,Sr,95,921696.802
57,39,96,Y,95,915891.343
56,40,96,Zr,95,908273.386
55,41,96,Nb,95,908100.647
54,42,96,Mo,95,904679.477
53,43,96,Tc,95,907871.383
52,44,96,Ru,95,907597.835
51,45,96,Rh,95,914460.631
50,46,96,Pd,95,918164.359
49,47,96,Ag,95,930680
48,48,96,Cd,95,939770
62,35,97,Br,96,962800
61,36,97,Kr,96,948560
60,37,97,Rb,96,937351.916
59,38,97,Sr,96,926152.923
58,39,97,Y,96,918133.995
57,40,97,Zr,96,910953.109
56,41,97,Nb,96,908098.556
55,42,97,Mo,96,906021.465
54,43,97,Tc,96,906365.358
53,44,97,Ru,96,907554.7
52,45,97,Rh,96,911336.797
51,46,97,Pd,96,916479.073
50,47,97,Ag,96,923972.412
49,48,97,Cd,96,934940
48,49,97,In,96,949540
62,36,98,Kr,97,951910
61,37,98,Rb,97,941790.668
60,38,98,Sr,97,928452.934
59,39,98,Y,97,922203.02
58,40,98,Zr,97,912734.892
57,41,98,Nb,97,910328.412
56,42,98,Mo,97,905408.169
55,43,98,Tc,97,907215.966
54,44,98,Ru,97,905287.132
53,45,98,Rh,97,910708.158
52,46,98,Pd,97,912720.902
51,47,98,Ag,97,921566.201
50,48,98,Cd,97,927395.546
49,49,98,In,97,942140
63,36,99,Kr,98,957600
62,37,99,Rb,98,945379.283
61,38,99,Sr,98,933240.926
60,39,99,Y,98,924636.204
59,40,99,Zr,98,916512.106
58,41,99,Nb,98,911618.375
57,42,99,Mo,98,907711.87
56,43,99,Tc,98,906254.747
55,44,99,Ru,98,905939.302
54,45,99,Rh,98,908132.104
53,46,99,Pd,98,911767.833
52,47,99,Ag,98,917597.178
51,48,99,Cd,98,925010
50,49,99,In,98,934220
49,50,99,Sn,98,949330
64,36,100,Kr,99,961140
63,37,100,Rb,99,949870
62,38,100,Sr,99,935351.911
61,39,100,Y,99,927756.586
60,40,100,Zr,99,917761.889
59,41,100,Nb,99,914181.619
58,42,100,Mo,99,907477.336
57,43,100,Tc,99,907657.78
56,44,100,Ru,99,904219.476
55,45,100,Rh,99,908121.55
54,46,100,Pd,99,908505.886
53,47,100,Ag,99,916104.255
52,48,100,Cd,99,920289.525
51,49,100,In,99,931110.851
50,50,100,Sn,99,939044.343
64,37,101,Rb,100,953196.445
63,38,101,Sr,100,940517.888
62,39,101,Y,100,930313.85
61,40,101,Zr,100,921140.415
60,41,101,Nb,100,915252.025
59,42,101,Mo,100,910347.001
58,43,101,Tc,100,907314.659
57,44,101,Ru,100,905582.087
56,45,101,Rh,100,906163.625
55,46,101,Pd,100,908289.242
54,47,101,Ag,100,912802.233
53,48,101,Cd,100,918681.538
52,49,101,In,100,926340
51,50,101,Sn,100,936060
65,37,102,Rb,101,958870
64,38,102,Sr,101,943018.987
63,39,102,Y,101,933555.695
62,40,102,Zr,101,922981.285
61,41,102,Nb,101,918037.614
60,42,102,Mo,101,910297.36
59,43,102,Tc,101,909215.019
58,44,102,Ru,101,904349.312
57,45,102,Rh,101,906843.196
56,46,102,Pd,101,905608.544
55,47,102,Ag,101,911685
54,48,102,Cd,101,914462.258
53,49,102,In,101,924090.238
52,50,102,Sn,101,930295.324
65,38,103,Sr,102,948950
64,39,103,Y,102,936730
63,40,103,Zr,102,926599.606
62,41,103,Nb,102,919143.842
61,42,103,Mo,102,913207.142
60,43,103,Tc,102,909181.351
59,44,103,Ru,102,906323.847
58,45,103,Rh,102,905504.292
57,46,103,Pd,102,906087.307
56,47,103,Ag,102,908972.72
55,48,103,Cd,102,913419.246
54,49,103,In,102,919914.188
53,50,103,Sn,102,928100
52,51,103,Sb,102,939690
66,38,104,Sr,103,952330
65,39,104,Y,103,941050
64,40,104,Zr,103,928780
63,41,104,Nb,103,922464.701
62,42,104,Mo,103,913763.625
61,43,104,Tc,103,911447.454
60,44,104,Ru,103,905432.701
59,45,104,Rh,103,906655.518
58,46,104,Pd,103,904035.834
57,47,104,Ag,103,908629.157
56,48,104,Cd,103,909849.475
55,49,104,In,103,918296.171
54,50,104,Sn,103,923143.223
53,51,104,Sb,103,936472
67,38,105,Sr,104,958580
66,39,105,Y,104,944870
65,40,105,Zr,104,933050
64,41,105,Nb,104,923936.545
63,42,105,Mo,104,916974.61
62,43,105,Tc,104,911660.566
61,44,105,Ru,104,907752.866
60,45,105,Rh,104,905693.821
59,46,105,Pd,104,905084.92
58,47,105,Ag,104,906528.661
57,48,105,Cd,104,909467.905
56,49,105,In,104,914673.54
55,50,105,Sn,104,921349.437
54,51,105,Sb,104,931486.348
53,52,105,Te,104,943640
67,39,106,Y,105,949790
66,40,106,Zr,105,935910
65,41,106,Nb,105,927970
64,42,106,Mo,105,918136.802
63,43,106,Tc,105,914357.927
62,44,106,Ru,105,907329.433
61,45,106,Rh,105,907287.135
60,46,106,Pd,105,903485.715
59,47,106,Ag,105,906668.921
58,48,106,Cd,105,906459.41
57,49,106,In,105,913465.411
56,50,106,Sn,105,916880.62
55,51,106,Sb,105,928791
54,52,106,Te,105,937504.237
68,39,107,Y,106,954140
67,40,107,Zr,106,940750
66,41,107,Nb,106,930310
65,42,107,Mo,106,921692.604
64,43,107,Tc,106,915079.572
63,44,107,Ru,106,909905.089
62,45,107,Rh,106,906748.423
61,46,107,Pd,106,905133.481
60,47,107,Ag,106,905096.82
59,48,107,Cd,106,906617.928
58,49,107,In,106,910295.1
57,50,107,Sn,106,915644.329
56,51,107,Sb,106,924150
55,52,107,Te,106,935006
69,39,108,Y,107,959480
68,40,108,Zr,107,943960
67,41,108,Nb,107,934840
66,42,108,Mo,107,923453
65,43,108,Tc,107,918461.226
64,44,108,Ru,107,910173.465
63,45,108,Rh,107,908728.018
62,46,108,Pd,107,903891.701
61,47,108,Ag,107,905955.556
60,48,108,Cd,107,904183.683
59,49,108,In,107,909698.18
58,50,108,Sn,107,911925.378
57,51,108,Sb,107,922160
56,52,108,Te,107,929444.597
55,53,108,I,107,943475
69,40,109,Zr,108,949240
68,41,109,Nb,108,937630
67,42,109,Mo,108,927810
66,43,109,Tc,108,919982.665
65,44,109,Ru,108,913203.233
64,45,109,Rh,108,908737.289
63,46,109,Pd,108,905950.451
62,47,109,Ag,108,904752.292
61,48,109,Cd,108,904982.293
60,49,109,In,108,907150.507
59,50,109,Sn,108,911283.214
58,51,109,Sb,108,918132.426
57,52,109,Te,108,927415.515
56,53,109,I,108,938149.417
70,40,110,Zr,109,952870
69,41,110,Nb,109,942440
68,42,110,Mo,109,929730
67,43,110,Tc,109,923820.483
66,44,110,Ru,109,914136.041
65,45,110,Rh,109,911136.411
64,46,110,Pd,109,905153.254
63,47,110,Ag,109,906107.231
62,48,110,Cd,109,903002.07
61,49,110,In,109,907165.274
60,50,110,Sn,109,907842.791
59,51,110,Sb,109,916753
58,52,110,Te,109,922407.316
57,53,110,I,109,935242
56,54,110,Xe,109,944278.068
70,41,111,Nb,110,945650
69,42,111,Mo,110,934410
68,43,111,Tc,110,925692.83
67,44,111,Ru,110,917696
66,45,111,Rh,110,911585.913
65,46,111,Pd,110,907670.734
64,47,111,Ag,110,905291.157
63,48,111,Cd,110,904178.107
62,49,111,In,110,905103.278
61,50,111,Sn,110,907734.46
60,51,111,Sb,110,913163
59,52,111,Te,110,921110.692
58,53,111,I,110,930276
57,54,111,Xe,110,941602
71,41,112,Nb,111,950830
70,42,112,Mo,111,936840
69,43,112,Tc,111,929146.493
68,44,112,Ru,111,918965
67,45,112,Rh,111,914394.159
66,46,112,Pd,111,907314.058
65,47,112,Ag,111,907004.814
64,48,112,Cd,111,902757.809
63,49,112,In,111,905532.331
62,50,112,Sn,111,904818.207
61,51,112,Sb,111,912398.009
60,52,112,Te,111,917013.672
59,53,112,I,111,927970
58,54,112,Xe,111,935623.112
57,55,112,Cs,111,950301
72,41,113,Nb,112,954700
71,42,113,Mo,112,941880
70,43,113,Tc,112,931590
69,44,113,Ru,112,922487.194
68,45,113,Rh,112,915530.627
67,46,113,Pd,112,910152.908
66,47,113,Ag,112,906566.579
65,48,113,Cd,112,904401.662
64,49,113,In,112,904057.761
63,50,113,Sn,112,905170.577
62,51,113,Sb,112,909371.672
61,52,113,Te,112,915891
60,53,113,I,112,923640.583
59,54,113,Xe,112,933341.174
58,55,113,Cs,112,944493.274
72,42,114,Mo,113,944920
71,43,114,Tc,113,935880
70,44,114,Ru,113,924281
69,45,114,Rh,113,918806
68,46,114,Pd,113,910362.638
67,47,114,Ag,113,908803.704
66,48,114,Cd,113,903358.54
65,49,114,In,113,904913.876
64,50,114,Sn,113,902778.869
63,51,114,Sb,113,909269
62,52,114,Te,113,912089
61,53,114,I,113,921850
60,54,114,Xe,113,927980.306
59,55,114,Cs,113,941450
58,56,114,Ba,113,950675.405
73,42,115,Mo,114,950290
72,43,115,Tc,114,938690
71,44,115,Ru,114,928686.173
70,45,115,Rh,114,920334
69,46,115,Pd,114,913683.824
68,47,115,Ag,114,908762.698
67,48,115,Cd,114,905430.969
66,49,115,In,114,903878.484
65,50,115,Sn,114,903342.397
64,51,115,Sb,114,906598
63,52,115,Te,114,911902
62,53,115,I,114,918048
61,54,115,Xe,114,926293.92
60,55,115,Cs,114,935910
59,56,115,Ba,114,947370
73,43,116,Tc,115,943370
72,44,116,Ru,115,930810
71,45,116,Rh,115,924062
70,46,116,Pd,115,914158.662
69,47,116,Ag,115,911359.933
68,48,116,Cd,115,904755.809
67,49,116,In,115,905259.703
66,50,116,Sn,115,901740.53
65,51,116,Sb,115,906793.629
64,52,116,Te,115,908460
63,53,116,I,115,916808.633
62,54,116,Xe,115,921581.087
61,55,116,Cs,115,933367
60,56,116,Ba,115,941380
74,43,117,Tc,116,946480
73,44,117,Ru,116,935580
72,45,117,Rh,116,925980
71,46,117,Pd,116,917841.338
70,47,117,Ag,116,911684.562
69,48,117,Cd,116,907218.618
68,49,117,In,116,904513.564
67,50,117,Sn,116,902951.656
66,51,117,Sb,116,904835.941
65,52,117,Te,116,908644.719
64,53,117,I,116,913650
63,54,117,Xe,116,920358.735
62,55,117,Cs,116,928670.701
61,56,117,Ba,116,938499
60,57,117,La,116,950068
75,43,118,Tc,117,951480
74,44,118,Ru,117,937820
73,45,118,Rh,117,930070
72,46,118,Pd,117,918984.3
71,47,118,Ag,117,914582.768
70,48,118,Cd,117,906914.53
69,49,118,In,117,906354.367
68,50,118,Sn,117,901603.167
67,51,118,Sb,117,905528.731
66,52,118,Te,117,905827.581
65,53,118,I,117,913074
64,54,118,Xe,117,916178.655
63,55,118,Cs,117,926559.494
62,56,118,Ba,117,933040
61,57,118,La,117,946730
75,44,119,Ru,118,942840
74,45,119,Rh,118,932110
73,46,119,Pd,118,923110
72,47,119,Ag,118,915665.059
71,48,119,Cd,118,909921.597
70,49,119,In,118,905845.35
69,50,119,Sn,118,903307.63
68,51,119,Sb,118,903942.009
67,52,119,Te,118,906403.645
66,53,119,I,118,910074
65,54,119,Xe,118,915410.688
64,55,119,Cs,118,922377.304
63,56,119,Ba,118,930659.661
62,57,119,La,118,940990
61,58,119,Ce,118,952760
76,44,120,Ru,119,945310
75,45,120,Rh,119,936410
74,46,120,Pd,119,924691.878
73,47,120,Ag,119,918787.384
72,48,120,Cd,119,909850.129
71,49,120,In,119,907959.608
70,50,120,Sn,119,902194.676
69,51,120,Sb,119,905072.427
68,52,120,Te,119,904020.222
67,53,120,I,119,910048.173
66,54,120,Xe,119,911784.244
65,55,120,Cs,119,920677.253
64,56,120,Ba,119,926044.974
63,57,120,La,119,938070
62,58,120,Ce,119,946640
76,45,121,Rh,120,938720
75,46,121,Pd,120,928870
74,47,121,Ag,120,919848.046
73,48,121,Cd,120,912977.363
72,49,121,In,120,907845.822
71,50,121,Sn,120,904235.48
70,51,121,Sb,120,903815.686
69,52,121,Te,120,904936.424
68,53,121,I,120,907366.811
67,54,121,Xe,120,911461.829
66,55,121,Cs,120,917229.209
65,56,121,Ba,120,924054.499
64,57,121,La,120,933010
63,58,121,Ce,120,943420
62,59,121,Pr,120,955364
77,45,122,Rh,121,943210
76,46,122,Pd,121,930550
75,47,122,Ag,121,923530
74,48,122,Cd,121,913332.432
73,49,122,In,121,910276.01
72,50,122,Sn,121,903439.046
71,51,122,Sb,121,905173.651
70,52,122,Te,121,903043.898
69,53,122,I,121,907589.284
68,54,122,Xe,121,908367.632
67,55,122,Cs,121,916113.434
66,56,122,Ba,121,919904
65,57,122,La,121,930710
64,58,122,Ce,121,937910
63,59,122,Pr,121,951810
77,46,123,Pd,122,934930
76,47,123,Ag,122,924900
75,48,123,Cd,122,917002.999
74,49,123,In,122,910438.276
73,50,123,Sn,122,905720.838
72,51,123,Sb,122,904213.97
71,52,123,Te,122,904270.029
70,53,123,I,122,905588.965
69,54,123,Xe,122,908481.91
68,55,123,Cs,122,912996.036
67,56,123,Ba,122,918781.036
66,57,123,La,122,926240
65,58,123,Ce,122,935400
64,59,123,Pr,122,945960
78,46,124,Pd,123,936880
77,47,124,Ag,123,928640
76,48,124,Cd,123,917647.616
75,49,124,In,123,913175.231
74,50,124,Sn,123,905273.946
73,51,124,Sb,123,905935.743
72,52,124,Te,123,902817.896
71,53,124,I,123,906209.852
70,54,124,Xe,123,905893.003
69,55,124,Cs,123,912257.798
68,56,124,Ba,123,915093.603
67,57,124,La,123,924574.275
66,58,124,Ce,123,930410
65,59,124,Pr,123,942960
64,60,124,Nd,123,952230
78,47,125,Ag,124,930430
77,48,125,Cd,124,921246.37
76,49,125,In,124,913600.588
75,50,125,Sn,124,907784.125
74,51,125,Sb,124,905253.818
73,52,125,Te,124,904430.731
72,53,125,I,124,904630.164
71,54,125,Xe,124,906395.464
70,55,125,Cs,124,909728.27
69,56,125,Ba,124,914472.912
68,57,125,La,124,920816.034
67,58,125,Ce,124,928440
66,59,125,Pr,124,937830
65,60,125,Nd,124,948880
79,47,126,Ag,125,934500
78,48,126,Cd,125,922353.321
77,49,126,In,125,916463.857
76,50,126,Sn,125,907653.28
75,51,126,Sb,125,907247.48
74,52,126,Te,125,903311.696
73,53,126,I,125,905624.153
72,54,126,Xe,125,904273.634
71,55,126,Cs,125,909451.977
70,56,126,Ba,125,911250.177
69,57,126,La,125,919512.667
68,58,126,Ce,125,923971
67,59,126,Pr,125,935310
66,60,126,Nd,125,943220
65,61,126,Pm,125,957520
80,47,127,Ag,126,936770
79,48,127,Cd,126,926443.864
78,49,127,In,126,917353.091
77,50,127,Sn,126,910360.024
76,51,127,Sb,126,906923.609
75,52,127,Te,126,905226.336
74,53,127,I,126,904472.681
73,54,127,Xe,126,905183.723
72,55,127,Cs,126,907417.525
71,56,127,Ba,126,911093.797
70,57,127,La,126,916375.448
69,58,127,Ce,126,922731
68,59,127,Pr,126,930830
67,60,127,Nd,126,940500
66,61,127,Pm,126,951630
81,47,128,Ag,127,941170
80,48,128,Cd,127,927762.285
79,49,128,In,127,920172.328
78,50,128,Sn,127,910536.624
77,51,128,Sb,127,909169.001
76,52,128,Te,127,904463.056
75,53,128,I,127,905809.443
74,54,128,Xe,127,903531.275
73,55,128,Cs,127,907748.866
72,56,128,Ba,127,908317.698
71,57,128,La,127,915585.177
70,58,128,Ce,127,918911
69,59,128,Pr,127,928791
68,60,128,Nd,127,935390
67,61,128,Pm,127,948420
66,62,128,Sm,127,958080
82,47,129,Ag,128,943690
81,48,129,Cd,128,932150
80,49,129,In,128,921696.98
79,50,129,Sn,128,913479
78,51,129,Sb,128,909148.442
77,52,129,Te,128,906598.238
76,53,129,I,128,904987.722
75,54,129,Xe,128,904779.435
74,55,129,Cs,128,906064.426
73,56,129,Ba,128,908679.439
72,57,129,La,128,912692.815
71,58,129,Ce,128,918102
70,59,129,Pr,128,925095
69,60,129,Nd,128,933188
68,61,129,Pm,128,943160
67,62,129,Sm,128,954640
83,47,130,Ag,129,950448
82,48,130,Cd,129,933901.937
81,49,130,In,129,924970.049
80,50,130,Sn,129,913967.295
79,51,130,Sb,129,911656.324
78,52,130,Te,129,906224.399
77,53,130,I,129,906674.247
76,54,130,Xe,129,903508.007
75,55,130,Cs,129,906708.552
74,56,130,Ba,129,906320.811
73,57,130,La,129,912368.724
72,58,130,Ce,129,914736
71,59,130,Pr,129,923590
70,60,130,Nd,129,928506
69,61,130,Pm,129,940450
68,62,130,Sm,129,948920
67,63,130,Eu,129,963569
83,48,131,Cd,130,940670
82,49,131,In,130,926851.767
81,50,131,Sn,130,916999.769
80,51,131,Sb,130,911982.275
79,52,131,Te,130,908523.864
78,53,131,I,130,906124.609
77,54,131,Xe,130,905082.362
76,55,131,Cs,130,905463.926
75,56,131,Ba,130,906941.118
74,57,131,La,130,910070
73,58,131,Ce,130,914422
72,59,131,Pr,130,920259
71,60,131,Nd,130,927247
70,61,131,Pm,130,935870
69,62,131,Sm,130,946110
68,63,131,Eu,130,957753
84,48,132,Cd,131,945550
83,49,132,In,131,932990.26
82,50,132,Sn,131,917815.713
81,51,132,Sb,131,914466.896
80,52,132,Te,131,908553.16
79,53,132,I,131,907997.381
78,54,132,Xe,131,904153.457
77,55,132,Cs,131,906434.26
76,56,132,Ba,131,905061.288
75,57,132,La,131,910101.145
74,58,132,Ce,131,911460.487
73,59,132,Pr,131,919255
72,60,132,Nd,131,923321.237
71,61,132,Pm,131,933750
70,62,132,Sm,131,940690
69,63,132,Eu,131,954370
84,49,133,In,132,937810
83,50,133,Sn,132,923829.249
82,51,133,Sb,132,915251.63
81,52,133,Te,132,910955.306
80,53,133,I,132,907796.939
79,54,133,Xe,132,905910.722
78,55,133,Cs,132,905451.932
77,56,133,Ba,132,906007.49
76,57,133,La,132,908218
75,58,133,Ce,132,911515.02
74,59,133,Pr,132,916330.532
73,60,133,Nd,132,922348
72,61,133,Pm,132,929782
71,62,133,Sm,132,938670
70,63,133,Eu,132,949240
85,49,134,In,133,944150
84,50,134,Sn,133,928291.765
83,51,134,Sb,133,920379.744
82,52,134,Te,133,911368.737
81,53,134,I,133,909744.465
80,54,134,Xe,133,905394.464
79,55,134,Cs,133,906718.475
78,56,134,Ba,133,904508.383
77,57,134,La,133,908514.011
76,58,134,Ce,133,908924.821
75,59,134,Pr,133,915711.737
74,60,134,Nd,133,918790.181
73,61,134,Pm,133,928353
72,62,134,Sm,133,933970
71,63,134,Eu,133,946510
70,64,134,Gd,133,955370
86,49,135,In,134,949330
85,50,135,Sn,134,934730
84,51,135,Sb,134,925165.771
83,52,135,Te,134,916448.592
82,53,135,I,134,910048.121
81,54,135,Xe,134,907227.495
80,55,135,Cs,134,905977.008
79,56,135,Ba,134,905688.591
78,57,135,La,134,906976.844
77,58,135,Ce,134,909151.396
76,59,135,Pr,134,913111.745
75,60,135,Nd,134,918181.16
74,61,135,Pm,134,924876
73,62,135,Sm,134,932520
72,63,135,Eu,134,941820
71,64,135,Gd,134,952570
86,50,136,Sn,135,939340
85,51,136,Sb,135,930350
84,52,136,Te,135,920101.246
83,53,136,I,135,914653.993
82,54,136,Xe,135,907218.794
81,55,136,Cs,135,907311.576
80,56,136,Ba,135,904575.945
79,57,136,La,135,907635.536
78,58,136,Ce,135,907172.422
77,59,136,Pr,135,912691.611
76,60,136,Nd,135,914976.035
75,61,136,Pm,135,923565.829
74,62,136,Sm,135,928275.527
73,63,136,Eu,135,939600
72,64,136,Gd,135,947340
71,65,136,Tb,135,961380
87,50,137,Sn,136,945990
86,51,137,Sb,136,935310
85,52,137,Te,136,925322.954
84,53,137,I,136,917870.84
83,54,137,Xe,136,911562.125
82,55,137,Cs,136,907089.473
81,56,137,Ba,136,905827.384
80,57,137,La,136,906493.598
79,58,137,Ce,136,907805.577
78,59,137,Pr,136,910705.455
77,60,137,Nd,136,914567.137
76,61,137,Pm,136,920479.493
75,62,137,Sm,136,926971.746
74,63,137,Eu,136,935570
73,64,137,Gd,136,945020
72,65,137,Tb,136,955980
87,51,138,Sb,137,940790
86,52,138,Te,137,929220
85,53,138,I,137,922349.591
84,54,138,Xe,137,913954.475
83,55,138,Cs,137,911016.704
82,56,138,Ba,137,905247.237
81,57,138,La,137,907111.93
80,58,138,Ce,137,905991.321
79,59,138,Pr,137,910754.636
78,60,138,Nd,137,911949.961
77,61,138,Pm,137,919548.281
76,62,138,Sm,137,923243.961
75,63,138,Eu,137,933709
74,64,138,Gd,137,940120
73,65,138,Tb,137,953160
72,66,138,Dy,137,962490
88,51,139,Sb,138,945980
87,52,139,Te,138,934730
86,53,139,I,138,926099.478
85,54,139,Xe,138,918792.936
84,55,139,Cs,138,913363.999
83,56,139,Ba,138,908841.341
82,57,139,La,138,906353.267
81,58,139,Ce,138,906652.651
80,59,139,Pr,138,908938.399
79,60,139,Nd,138,911978.288
78,61,139,Pm,138,916804.082
77,62,139,Sm,138,922296.605
76,63,139,Eu,138,929792.28
75,64,139,Gd,138,938240
74,65,139,Tb,138,948290
73,66,139,Dy,138,959540
88,52,140,Te,139,938850
87,53,140,I,139,931000
86,54,140,Xe,139,921640.943
85,55,140,Cs,139,917282.354
84,56,140,Ba,139,910604.505
83,57,140,La,139,909477.645
82,58,140,Ce,139,905438.706
81,59,140,Pr,139,909075.874
80,60,140,Nd,139,909552
79,61,140,Pm,139,916041.789
78,62,140,Sm,139,918994.687
77,63,140,Eu,139,928087.607
76,64,140,Gd,139,933674
75,65,140,Tb,139,945805.049
74,66,140,Dy,139,954010
73,67,140,Ho,139,968539
89,52,141,Te,140,944650
88,53,141,I,140,935030
87,54,141,Xe,140,926648.049
86,55,141,Cs,140,920045.752
85,56,141,Ba,140,914411.009
84,57,141,La,140,910962.152
83,58,141,Ce,140,908276.27
82,59,141,Pr,140,907652.769
81,60,141,Nd,140,909609.854
80,61,141,Pm,140,913555.054
79,62,141,Sm,140,918476.488
78,63,141,Eu,140,924930.72
77,64,141,Gd,140,932126
76,65,141,Tb,140,941448
75,66,141,Dy,140,951350
74,67,141,Ho,140,963098
90,52,142,Te,141,949080
89,53,142,I,141,940180
88,54,142,Xe,141,929709.59
87,55,142,Cs,141,924298.927
86,56,142,Ba,141,916453.41
85,57,142,La,141,914079.13
84,58,142,Ce,141,909244.205
83,59,142,Pr,141,910044.806
82,60,142,Nd,141,907723.297
81,61,142,Pm,141,912874.471
80,62,142,Sm,141,915197.641
79,63,142,Eu,141,923434.945
78,64,142,Gd,141,928116
77,65,142,Tb,141,938744
76,66,142,Dy,141,946366
75,67,142,Ho,141,959770
90,53,143,I,142,944560
89,54,143,Xe,142,935110
88,55,143,Cs,142,927351.75
87,56,143,Ba,142,920626.719
86,57,143,La,142,916062.72
85,58,143,Ce,142,912385.91
84,59,143,Pr,142,910816.926
83,60,143,Nd,142,909814.29
82,61,143,Pm,142,910932.616
81,62,143,Sm,142,914628.338
80,63,143,Eu,142,920297.509
79,64,143,Gd,142,926749.51
78,65,143,Tb,142,935121
77,66,143,Dy,142,943830
76,67,143,Ho,142,954610
75,68,143,Er,142,966340
91,53,144,I,143,949990
90,54,144,Xe,143,938510
89,55,144,Cs,143,932076.914
88,56,144,Ba,143,922952.853
87,57,144,La,143,919599.647
86,58,144,Ce,143,913647.336
85,59,144,Pr,143,913305.245
84,60,144,Nd,143,910087.274
83,61,144,Pm,143,912590.843
82,62,144,Sm,143,911999.478
81,63,144,Eu,143,918816.823
80,64,144,Gd,143,922963
79,65,144,Tb,143,933045
78,66,144,Dy,143,939254
77,67,144,Ho,143,951480
76,68,144,Er,143,960380
91,54,145,Xe,144,944070
90,55,145,Cs,144,935526.17
89,56,145,Ba,144,927627.032
88,57,145,La,144,921645.401
87,58,145,Ce,144,917233.135
86,59,145,Pr,144,914511.7
85,60,145,Nd,144,912573.636
84,61,145,Pm,144,912749.023
83,62,145,Sm,144,913410.353
82,63,145,Eu,144,916265.237
81,64,145,Gd,144,921709.252
80,65,145,Tb,144,929274
79,66,145,Dy,144,937425
78,67,145,Ho,144,947200
77,68,145,Er,144,957390
76,69,145,Tm,144,970073
92,54,146,Xe,145,947750
91,55,146,Cs,145,940289.423
90,56,146,Ba,145,930219.572
89,57,146,La,145,925793.46
88,58,146,Ce,145,918759.009
87,59,146,Pr,145,917644.336
86,60,146,Nd,145,913116.939
85,61,146,Pm,145,914696.305
84,62,146,Sm,145,913040.9
83,63,146,Eu,145,917205.817
82,64,146,Gd,145,918310.608
81,65,146,Tb,145,927246.584
80,66,146,Dy,145,932845.369
79,67,146,Ho,145,944640
78,68,146,Er,145,952000
77,69,146,Tm,145,966425
93,54,147,Xe,146,953560
92,55,147,Cs,146,944155.008
91,56,147,Ba,146,934945
90,57,147,La,146,928235.284
89,58,147,Ce,146,922673.954
88,59,147,Pr,146,918995.992
87,60,147,Nd,146,916100.441
86,61,147,Pm,146,915138.545
85,62,147,Sm,146,914897.923
84,63,147,Eu,146,916746.111
83,64,147,Gd,146,919094.42
82,65,147,Tb,146,924044.585
81,66,147,Dy,146,931091.5
80,67,147,Ho,146,940056
79,68,147,Er,146,949490
78,69,147,Tm,146,960961
93,55,148,Cs,147,949218.153
92,56,148,Ba,147,937720.047
91,57,148,La,147,932228.868
90,58,148,Ce,147,924432.41
89,59,148,Pr,147,922135.026
88,60,148,Nd,147,916893.288
87,61,148,Pm,147,917474.618
86,62,148,Sm,147,914822.674
85,63,148,Eu,147,918085.895
84,64,148,Gd,147,918114.524
83,65,148,Tb,147,924271.701
82,66,148,Dy,147,927149.831
81,67,148,Ho,147,937718
80,68,148,Er,147,944550
79,69,148,Tm,147,957840
78,70,148,Yb,147,967420
94,55,149,Cs,148,952930
93,56,149,Ba,148,942580
92,57,149,La,148,934734
91,58,149,Ce,148,928399.883
90,59,149,Pr,148,923717.651
89,60,149,Nd,148,920148.842
88,61,149,Pm,148,918334.155
87,62,149,Sm,148,917184.735
86,63,149,Eu,148,917931.238
85,64,149,Gd,148,919340.915
84,65,149,Tb,148,923245.909
83,66,149,Dy,148,927304.787
82,67,149,Ho,148,933774.771
81,68,149,Er,148,942306
80,69,149,Tm,148,952720
79,70,149,Yb,148,964040
95,55,150,Cs,149,958170
94,56,150,Ba,149,945680
93,57,150,La,149,938770
92,58,150,Ce,149,930408.931
91,59,150,Pr,149,926672.997
90,60,150,Nd,149,920890.888
89,61,150,Pm,149,920983.561
88,62,150,Sm,149,917275.539
87,63,150,Eu,149,919701.819
86,64,150,Gd,149,918658.876
85,65,150,Tb,149,923659.686
84,66,150,Dy,149,925585.184
83,67,150,Ho,149,933496.182
82,68,150,Er,149,937913.839
81,69,150,Tm,149,949960
80,70,150,Yb,149,958420
79,71,150,Lu,149,973228
96,55,151,Cs,150,962190
95,56,151,Ba,150,950810
94,57,151,La,150,941720
93,58,151,Ce,150,933976.196
92,59,151,Pr,150,928318.618
91,60,151,Nd,150,923828.929
90,61,151,Pm,150,921206.973
89,62,151,Sm,150,919932.409
88,63,151,Eu,150,919850.161
87,64,151,Gd,150,920348.482
86,65,151,Tb,150,923102.543
85,66,151,Dy,150,926184.601
84,67,151,Ho,150,931688.142
83,68,151,Er,150,937448.903
82,69,151,Tm,150,945483.49
81,70,151,Yb,150,955400.769
80,71,151,Lu,150,967577
96,56,152,Ba,151,954270
95,57,152,La,151,946250
94,58,152,Ce,151,936540
93,59,152,Pr,151,931499.225
92,60,152,Nd,151,924682.219
91,61,152,Pm,151,923496.795
90,62,152,Sm,151,919732.425
89,63,152,Eu,151,921744.534
88,64,152,Gd,151,919790.996
87,65,152,Tb,151,924074.438
86,66,152,Dy,151,924718.3
85,67,152,Ho,151,931713.714
84,68,152,Er,151,935050.389
83,69,152,Tm,151,944422
82,70,152,Yb,151,950288.919
81,71,152,Lu,151,964120
97,56,153,Ba,152,959610
96,57,153,La,152,949620
95,58,153,Ce,152,940580
94,59,153,Pr,152,933838.905
93,60,153,Nd,152,927698.232
92,61,153,Pm,152,924116.889
91,62,153,Sm,152,922097.356
90,63,153,Eu,152,921230.339
89,64,153,Gd,152,921749.543
88,65,153,Tb,152,923434.588
87,66,153,Dy,152,925764.67
86,67,153,Ho,152,930198.789
85,68,153,Er,152,935063.492
84,69,153,Tm,152,942012.112
83,70,153,Yb,152,949480
82,71,153,Lu,152,958767.331
81,72,153,Hf,152,970690
97,57,154,La,153,954500
96,58,154,Ce,153,943420
95,59,154,Pr,153,937518.153
94,60,154,Nd,153,929477.307
93,61,154,Pm,153,926463.943
92,62,154,Sm,153,922209.273
91,63,154,Eu,153,922979.237
90,64,154,Gd,153,920865.598
89,65,154,Tb,153,924678.019
88,66,154,Dy,153,924424.457
87,67,154,Ho,153,930601.579
86,68,154,Er,153,932783.081
85,69,154,Tm,153,941567.808
84,70,154,Yb,153,946393.928
83,71,154,Lu,153,957522
82,72,154,Hf,153,964860
98,57,155,La,154,958350
97,58,155,Ce,154,948040
96,59,155,Pr,154,940120
95,60,155,Nd,154,932932
94,61,155,Pm,154,928101.267
93,62,155,Sm,154,924640.161
92,63,155,Eu,154,922893.26
91,64,155,Gd,154,922622.022
90,65,155,Tb,154,923505.236
89,66,155,Dy,154,925753.775
88,67,155,Ho,154,929103.491
87,68,155,Er,154,933208.949
86,69,155,Tm,154,939199.459
85,70,155,Yb,154,945782.332
84,71,155,Lu,154,954316.216
83,72,155,Hf,154,963390
82,73,155,Ta,154,974592
98,58,156,Ce,155,951260
97,59,156,Pr,155,944270
96,60,156,Nd,155,935018.114
95,61,156,Pm,155,931056.736
94,62,156,Sm,155,925527.887
93,63,156,Eu,155,924752.249
92,64,156,Gd,155,922122.743
91,65,156,Tb,155,924747.213
90,66,156,Dy,155,924283.11
89,67,156,Ho,155,929839
88,68,156,Er,155,931064.698
87,69,156,Tm,155,938979.933
86,70,156,Yb,155,942818.215
85,71,156,Lu,155,953032.523
84,72,156,Hf,155,959364.025
83,73,156,Ta,155,972303
99,58,157,Ce,156,956340
98,59,157,Pr,156,947430
97,60,157,Nd,156,939030
96,61,157,Pm,156,933039.369
95,62,157,Sm,156,928358.717
94,63,157,Eu,156,925423.647
93,64,157,Gd,156,923960.135
92,65,157,Tb,156,924024.604
91,66,157,Dy,156,925466.095
90,67,157,Ho,156,928256.188
89,68,157,Er,156,931916
88,69,157,Tm,156,936973
87,70,157,Yb,156,942627.848
86,71,157,Lu,156,950098.3
85,72,157,Hf,156,958396
84,73,157,Ta,156,968192.445
99,59,158,Pr,157,951980
98,60,158,Nd,157,941600
97,61,158,Pm,157,936561.407
96,62,158,Sm,157,929991.317
95,63,158,Eu,157,927845.302
94,64,158,Gd,157,924103.912
93,65,158,Tb,157,925413.137
92,66,158,Dy,157,924409.487
91,67,158,Ho,157,928941.007
90,68,158,Er,157,929893.474
89,69,158,Tm,157,936979.525
88,70,158,Yb,157,939865.617
87,71,158,Lu,157,949313.283
86,72,158,Hf,157,954799.366
85,73,158,Ta,157,966699
84,74,158,W,157,974562
100,59,159,Pr,158,955500
99,60,159,Nd,158,946090
98,61,159,Pm,158,938970
97,62,159,Sm,158,933211.271
96,63,159,Eu,158,929088.861
95,64,159,Gd,158,926388.658
94,65,159,Tb,158,925346.757
93,66,159,Dy,158,925739.214
92,67,159,Ho,158,927711.959
91,68,159,Er,158,930684.066
90,69,159,Tm,158,934975
89,70,159,Yb,158,940050.099
88,71,159,Lu,158,946628.776
87,72,159,Hf,158,953994.87
86,73,159,Ta,158,963018.173
85,74,159,W,158,972918
100,60,160,Nd,159,949090
99,61,160,Pm,159,942990
98,62,160,Sm,159,935140
97,63,160,Eu,159,931971
96,64,160,Gd,159,927054.146
95,65,160,Tb,159,927167.606
94,66,160,Dy,159,925197.517
93,67,160,Ho,159,928729.478
92,68,160,Er,159,929083.292
91,69,160,Tm,159,935262.801
90,70,160,Yb,159,937552.344
89,71,160,Lu,159,946033
88,72,160,Hf,159,950684.379
87,73,160,Ta,159,961486.056
86,74,160,W,159,968478.805
85,75,160,Re,159,982115
101,60,161,Nd,160,953880
100,61,161,Pm,160,945860
99,62,161,Sm,160,938830
98,63,161,Eu,160,933680
97,64,161,Gd,160,929669.211
96,65,161,Tb,160,927569.919
95,66,161,Dy,160,926933.364
94,67,161,Ho,160,927854.776
93,68,161,Er,160,929995.309
92,69,161,Tm,160,933549
91,70,161,Yb,160,937901.678
90,71,161,Lu,160,943572
89,72,161,Hf,160,950274.844
88,73,161,Ta,160,958417
87,74,161,W,160,967357
86,75,161,Re,160,977589.119
101,61,162,Pm,161,950290
100,62,162,Sm,161,941220
99,63,162,Eu,161,937040
98,64,162,Gd,161,930984.751
97,65,162,Tb,161,929488.234
96,66,162,Dy,161,926798.447
95,67,162,Ho,161,929095.504
94,68,162,Er,161,928778.264
93,69,162,Tm,161,933994.682
92,70,162,Yb,161,935768.21
91,71,162,Lu,161,943277.288
90,72,162,Hf,161,947210.498
89,73,162,Ta,161,957291.859
88,74,162,W,161,963497.417
87,75,162,Re,161,976002
86,76,162,Os,161,984431
102,61,163,Pm,162,953680
101,62,163,Sm,162,945360
100,63,163,Eu,162,939210
99,64,163,Gd,162,933990
98,65,163,Tb,162,930647.536
97,66,163,Dy,162,928731.159
96,67,163,Ho,162,928733.903
95,68,163,Er,162,930032.749
94,69,163,Tm,162,932651.124
93,70,163,Yb,162,936334.305
92,71,163,Lu,162,941179
91,72,163,Hf,162,947089
90,73,163,Ta,162,954330.271
89,74,163,W,162,962523.542
88,75,163,Re,162,972080.535
87,76,163,Os,162,982690
102,62,164,Sm,163,948280
101,63,164,Eu,163,942990
100,64,164,Gd,163,935860
99,65,164,Tb,163,933350.838
98,66,164,Dy,163,929174.751
97,67,164,Ho,163,930233.507
96,68,164,Er,163,929200.229
95,69,164,Tm,163,933560
94,70,164,Yb,163,934489.416
93,71,164,Lu,163,941339
92,72,164,Hf,163,944367.284
91,73,164,Ta,163,953534
90,74,164,W,163,958954.382
89,75,164,Re,163,970323
88,76,164,Os,163,978035.649
87,77,164,Ir,163,992201
103,62,165,Sm,164,952980
102,63,165,Eu,164,945720
101,64,165,Gd,164,939380
100,65,165,Tb,164,934880
99,66,165,Dy,164,931703.333
98,67,165,Ho,164,930322.07
97,68,165,Er,164,930726.003
96,69,165,Tm,164,932435.492
95,70,165,Yb,164,935279
94,71,165,Lu,164,939406.724
93,72,165,Hf,164,944567
92,73,165,Ta,164,950772.514
91,74,165,W,164,958279.949
90,75,165,Re,164,967088.557
89,76,165,Os,164,976762
88,77,165,Ir,164,987520
103,63,166,Eu,165,949970
102,64,166,Gd,165,941600
101,65,166,Tb,165,937991.959
100,66,166,Dy,165,932806.741
99,67,166,Ho,165,932284.162
98,68,166,Er,165,930293.061
97,69,166,Tm,165,933554.131
96,70,166,Yb,165,933882.042
95,71,166,Lu,165,939859
94,72,166,Hf,165,942180
93,73,166,Ta,165,950512
92,74,166,W,165,955027.253
91,75,166,Re,165,965808
90,76,166,Os,165,972690.753
89,77,166,Ir,165,985824
88,78,166,Pt,165,994855
104,63,167,Eu,166,953210
103,64,167,Gd,166,945570
102,65,167,Tb,166,940050
101,66,167,Dy,166,935655.462
100,67,167,Ho,166,933132.633
99,68,167,Er,166,932048.159
98,69,167,Tm,166,932851.622
97,70,167,Yb,166,934949.605
96,71,167,Lu,166,938270
95,72,167,Hf,166,942600
94,73,167,Ta,166,948093
93,74,167,W,166,954816.014
92,75,167,Re,166,962601
91,76,167,Os,166,971547.969
90,77,167,Ir,166,981665.156
89,78,167,Pt,166,992979
104,64,168,Gd,167,948360
103,65,168,Tb,167,943640
102,66,168,Dy,167,937128.769
101,67,168,Ho,167,935515.708
100,68,168,Er,167,932370.224
99,69,168,Tm,167,934172.776
98,70,168,Yb,167,933896.895
97,71,168,Lu,167,938739.111
96,72,168,Hf,167,940568
95,73,168,Ta,167,948047
94,74,168,W,167,951808.394
93,75,168,Re,167,961572.608
92,76,168,Os,167,967803.678
91,77,168,Ir,167,979881
90,78,168,Pt,167,988150.742
105,64,169,Gd,168,952870
104,65,169,Tb,168,946220
103,66,169,Dy,168,940307.614
102,67,169,Ho,168,936872.273
101,68,169,Er,168,934590.364
100,69,169,Tm,168,934213.25
99,70,169,Yb,168,935189.802
98,71,169,Lu,168,937651.439
97,72,169,Hf,168,941259
96,73,169,Ta,168,946011
95,74,169,W,168,951778.79
94,75,169,Re,168,958791.096
93,76,169,Os,168,967019.27
92,77,169,Ir,168,976294.942
91,78,169,Pt,168,986715
90,79,169,Au,168,998080
105,65,170,Tb,169,950250
104,66,170,Dy,169,942390
103,67,170,Ho,169,939618.929
102,68,170,Er,169,935464.312
101,69,170,Tm,169,935801.397
100,70,170,Yb,169,934761.837
99,71,170,Lu,169,938474.968
98,72,170,Hf,169,939609
97,73,170,Ta,169,946175
96,74,170,W,169,949228.482
95,75,170,Re,169,958220.071
94,76,170,Os,169,963577.028
93,77,170,Ir,169,974965
92,78,170,Pt,169,982495.289
91,79,170,Au,169,996122
106,65,171,Tb,170,953300
105,66,171,Dy,170,946200
104,67,171,Ho,170,941465.15
103,68,171,Er,170,938029.808
102,69,171,Tm,170,936429.44
101,70,171,Yb,170,936325.799
100,71,171,Lu,170,937913.136
99,72,171,Hf,170,940492
98,73,171,Ta,170,944476
97,74,171,W,170,949451
96,75,171,Re,170,955716
95,76,171,Os,170,963184.819
94,77,171,Ir,170,971626.042
93,78,171,Pt,170,981244.542
92,79,171,Au,170,991878.881
91,80,171,Hg,171,3760
106,66,172,Dy,171,948760
105,67,172,Ho,171,944820
104,68,172,Er,171,939356.113
103,69,172,Tm,171,938400.044
102,70,172,Yb,171,936381.469
101,71,172,Lu,171,939085.669
100,72,172,Hf,171,939448.301
99,73,172,Ta,171,944895
98,74,172,W,171,947292
97,75,172,Re,171,955422.961
96,76,172,Os,171,960023.303
95,77,172,Ir,171,970456
94,78,172,Pt,171,977347.128
93,79,172,Au,171,990035
92,80,172,Hg,171,998832.686
107,66,173,Dy,172,953000
106,67,173,Ho,172,947290
105,68,173,Er,172,942400
104,69,173,Tm,172,939603.607
103,70,173,Yb,172,938210.787
102,71,173,Lu,172,938930.602
101,72,173,Hf,172,940513
100,73,173,Ta,172,943750
99,74,173,W,172,947689
98,75,173,Re,172,953243
97,76,173,Os,172,959808.409
96,77,173,Ir,172,967501.739
95,78,173,Pt,172,976444.754
94,79,173,Au,172,986237.38
93,80,173,Hg,172,997242
107,67,174,Ho,173,951150
106,68,174,Er,173,944230
105,69,174,Tm,173,942168.605
104,70,174,Yb,173,938862.089
103,71,174,Lu,173,940337.48
102,72,174,Hf,173,940046.178
101,73,174,Ta,173,944454
100,74,174,W,173,946079
99,75,174,Re,173,953115
98,76,174,Os,173,957062.202
97,77,174,Ir,173,966861.045
96,78,174,Pt,173,972818.767
95,79,174,Au,173,984761
94,80,174,Hg,173,992863.695
108,67,175,Ho,174,954050
107,68,175,Er,174,947770
106,69,175,Tm,174,943836.853
105,70,175,Yb,174,941276.45
104,71,175,Lu,174,940771.819
103,72,175,Hf,174,941509.181
102,73,175,Ta,174,943737
101,74,175,W,174,946717
100,75,175,Re,174,951381
99,76,175,Os,174,956945.835
98,77,175,Ir,174,964112.895
97,78,175,Pt,174,972420.552
96,79,175,Au,174,981274.107
95,80,175,Hg,174,991423.27
108,68,176,Er,175,950080
107,69,176,Tm,175,946994.685
106,70,176,Yb,175,942571.683
105,71,176,Lu,175,942686.31
104,72,176,Hf,175,941408.631
103,73,176,Ta,175,944857
102,74,176,W,175,945634
101,75,176,Re,175,951623
100,76,176,Os,175,954806
99,77,176,Ir,175,963648.688
98,78,176,Pt,175,968944.622
97,79,176,Au,175,980099
96,80,176,Hg,175,987354.58
95,81,176,Tl,176,590
109,68,177,Er,176,954050
108,69,177,Tm,176,949040
107,70,177,Yb,176,945260.822
106,71,177,Lu,176,943758.055
105,72,177,Hf,176,943220.651
104,73,177,Ta,176,944472.403
103,74,177,W,176,946643
102,75,177,Re,176,950328
101,76,177,Os,176,954965.324
100,77,177,Ir,176,961301.5
99,78,177,Pt,176,968469.481
98,79,177,Au,176,976864.908
97,80,177,Hg,176,986279.158
96,81,177,Tl,176,996427.286
109,69,178,Tm,177,952640
108,70,178,Yb,177,946646.68
107,71,178,Lu,177,945954.559
106,72,178,Hf,177,943698.766
105,73,178,Ta,177,945778.221
104,74,178,W,177,945876.236
103,75,178,Re,177,950989
102,76,178,Os,177,953251.241
101,77,178,Ir,177,961082
100,78,178,Pt,177,965648.724
99,79,178,Au,177,976031.92
98,80,178,Hg,177,982483.143
97,81,178,Tl,177,994897
96,82,178,Pb,178,3830.191
110,69,179,Tm,178,955340
109,70,179,Yb,178,950170
108,71,179,Lu,178,947327.443
107,72,179,Hf,178,945816.145
106,73,179,Ta,178,945929.535
105,74,179,W,178,947070.447
104,75,179,Re,178,949987.641
103,76,179,Os,178,953816.017
102,77,179,Ir,178,959122.266
101,78,179,Pt,178,965363.404
100,79,179,Au,178,973212.812
99,80,179,Hg,178,981833.861
98,81,179,Tl,178,991089.082
97,82,179,Pb,179,2150
110,70,180,Yb,179,952330
109,71,180,Lu,179,949881.16
108,72,180,Hf,179,946549.953
107,73,180,Ta,179,947464.831
106,74,180,W,179,946704.459
105,75,180,Re,179,950789.084
104,76,180,Os,179,952378.803
103,77,180,Ir,179,959229.446
102,78,180,Pt,179,963031.477
101,79,180,Au,179,972521.124
100,80,180,Hg,179,978266.394
99,81,180,Tl,179,989906
98,82,180,Pb,179,997918.173
111,70,181,Yb,180,956150
110,71,181,Lu,180,951970
109,72,181,Hf,180,949101.246
108,73,181,Ta,180,947995.763
107,74,181,W,180,948197.248
106,75,181,Re,180,950067.916
105,76,181,Os,180,953244
104,77,181,Ir,180,957625.297
103,78,181,Pt,180,963097.285
102,79,181,Au,180,970079.048
101,80,181,Hg,180,977819.311
100,81,181,Tl,180,986257.447
99,82,181,Pb,180,996623.958
111,71,182,Lu,181,955040
110,72,182,Hf,181,950554.096
109,73,182,Ta,181,950151.849
108,74,182,W,181,948204.156
107,75,182,Re,181,951210.08
106,76,182,Os,181,952110.186
105,77,182,Ir,181,958076.296
104,78,182,Pt,181,961170.656
103,79,182,Au,181,969617.874
102,80,182,Hg,181,974689.964
101,81,182,Tl,181,985667.104
100,82,182,Pb,181,992671.842
112,71,183,Lu,182,957570
111,72,183,Hf,182,953530.439
110,73,183,Ta,182,951372.616
109,74,183,W,182,950222.951
108,75,183,Re,182,950819.841
107,76,183,Os,182,953126.102
106,77,183,Ir,182,956846.458
105,78,183,Pt,182,961596.703
104,79,183,Au,182,967593.034
103,80,183,Hg,182,974449.841
102,81,183,Tl,182,982192.802
101,82,183,Pb,182,991874.629
113,71,184,Lu,183,960910
112,72,184,Hf,183,955446.515
111,73,184,Ta,183,954007.966
110,74,184,W,183,950931.188
109,75,184,Re,183,952520.756
108,76,184,Os,183,952489.071
107,77,184,Ir,183,957476
106,78,184,Pt,183,959922.251
105,79,184,Au,183,967451.524
104,80,184,Hg,183,971713.051
103,81,184,Tl,183,981873.122
102,82,184,Pb,183,988142.339
101,83,184,Bi,184,1124
113,72,185,Hf,184,958820
112,73,185,Ta,184,955559.375
111,74,185,W,184,953419.264
110,75,185,Re,184,952954.982
109,76,185,Os,184,954042.265
108,77,185,Ir,184,956698
107,78,185,Pt,184,960619
106,79,185,Au,184,965789.411
105,80,185,Hg,184,971899.086
104,81,185,Tl,184,978791.305
103,82,185,Pb,184,987609.944
102,83,185,Bi,184,997625
114,72,186,Hf,185,960890
113,73,186,Ta,185,958552.023
112,74,186,W,185,954364.127
111,75,186,Re,185,954986.084
110,76,186,Os,185,953838.158
109,77,186,Ir,185,957946.104
108,78,186,Pt,185,959350.813
107,79,186,Au,185,965952.703
106,80,186,Hg,185,969361.79
105,81,186,Tl,185,978325
104,82,186,Pb,185,984238.945
103,83,186,Bi,185,996597.625
115,72,187,Hf,186,964590
114,73,187,Ta,186,960530
113,74,187,W,186,957160.466
112,75,187,Re,186,955753.109
111,76,187,Os,186,955750.458
110,77,187,Ir,186,957363.361
109,78,187,Pt,186,960587
108,79,187,Au,186,964567.541
107,80,187,Hg,186,969814.236
106,81,187,Tl,186,975905.897
105,82,187,Pb,186,983918.37
104,83,187,Bi,186,993157.835
116,72,188,Hf,187,966850
115,73,188,Ta,187,963700
114,74,188,W,187,958489.105
113,75,188,Re,187,958114.438
112,76,188,Os,187,955838.228
111,77,188,Ir,187,958853.121
110,78,188,Pt,187,959395.391
109,79,188,Au,187,965323.661
108,80,188,Hg,187,967577.049
107,81,188,Tl,187,976009.782
106,82,188,Pb,187,980874.338
105,83,188,Bi,187,992265.154
104,84,188,Po,187,999422.048
116,73,189,Ta,188,965830
115,74,189,W,188,961912.868
114,75,189,Re,188,959229.007
113,76,189,Os,188,958147.47
112,77,189,Ir,188,958718.935
111,78,189,Pt,188,960833.686
110,79,189,Au,188,963948.286
109,80,189,Hg,188,968190.034
108,81,189,Tl,188,973588.428
107,82,189,Pb,188,980807
106,83,189,Bi,188,989199.012
105,84,189,Po,188,998480.562
117,73,190,Ta,189,969230
116,74,190,W,189,963181.378
115,75,190,Re,189,961817.977
114,76,190,Os,189,958447.048
113,77,190,Ir,189,960545.968
112,78,190,Pt,189,959931.655
111,79,190,Au,189,964700.339
110,80,190,Hg,189,966322.449
109,81,190,Tl,189,973877.149
108,82,190,Pb,189,978081.517
107,83,190,Bi,189,988295.129
106,84,190,Po,189,995101.185
117,74,191,W,190,966600
116,75,191,Re,190,963125.242
115,76,191,Os,190,960929.718
114,77,191,Ir,190,960594.046
113,78,191,Pt,190,961676.661
112,79,191,Au,190,963704.225
111,80,191,Hg,190,967157.105
110,81,191,Tl,190,971786.154
109,82,191,Pb,190,978265
108,83,191,Bi,190,985786.119
107,84,191,Po,190,994574.485
118,74,192,W,191,968170
117,75,192,Re,191,965960
116,76,192,Os,191,961480.69
115,77,192,Ir,191,962605.012
114,78,192,Pt,191,961038.005
113,79,192,Au,191,964812.953
112,80,192,Hg,191,965634.327
111,81,192,Tl,191,972225
110,82,192,Pb,191,975785.171
109,83,192,Bi,191,985457.954
108,84,192,Po,191,991335.149
118,75,193,Re,192,967470
117,76,193,Os,192,964151.563
116,77,193,Ir,192,962926.43
115,78,193,Pt,192,962987.401
114,79,193,Au,192,964149.715
113,80,193,Hg,192,966665.421
112,81,193,Tl,192,970672
111,82,193,Pb,192,976173.234
110,83,193,Bi,192,982959.771
109,84,193,Po,192,991025.275
108,85,193,At,192,999843.112
119,75,194,Re,193,970420
118,76,194,Os,193,965182.083
117,77,194,Ir,193,965078.378
116,78,194,Pt,193,962680.253
115,79,194,Au,193,965365.25
114,80,194,Hg,193,965439.409
113,81,194,Tl,193,971200
112,82,194,Pb,193,974012.07
111,83,194,Bi,193,982833.96
110,84,194,Po,193,988185.606
109,85,194,At,193,998725.085
119,76,195,Os,194,968126.661
118,77,195,Ir,194,965979.573
117,78,195,Pt,194,964791.134
116,79,195,Au,194,965034.64
115,80,195,Hg,194,966720.113
114,81,195,Tl,194,969774.335
113,82,195,Pb,194,974542.05
112,83,195,Bi,194,980650.737
111,84,195,Po,194,988110.728
110,85,195,At,194,996268.098
109,86,195,Rn,195,5437.696
120,76,196,Os,195,969639.333
119,77,196,Ir,195,968396.542
118,78,196,Pt,195,964951.521
117,79,196,Au,195,966569.813
116,80,196,Hg,195,965832.649
115,81,196,Tl,195,970481.151
114,82,196,Pb,195,972774.109
113,83,196,Bi,195,980666.509
112,84,196,Po,195,985534.58
111,85,196,At,195,995788.077
110,86,196,Rn,196,2115.223
120,77,197,Ir,196,969653.285
119,78,197,Pt,196,967340.182
118,79,197,Au,196,966568.662
117,80,197,Hg,196,967212.908
116,81,197,Tl,196,969574.511
115,82,197,Pb,196,973431.124
114,83,197,Bi,196,978864.454
113,84,197,Po,196,985659.63
112,85,197,At,196,993189.215
111,86,197,Rn,197,1584.351
121,77,198,Ir,197,972280
120,78,198,Pt,197,967892.79
119,79,198,Au,197,968242.303
118,80,198,Hg,197,966769.032
117,81,198,Tl,197,970483.495
116,82,198,Pb,197,972033.959
115,83,198,Bi,197,979206
114,84,198,Po,197,983388.616
113,85,198,At,197,992837.202
112,86,198,Rn,197,998678.663
122,77,199,Ir,198,973804.583
121,78,199,Pt,198,970593.094
120,79,199,Au,198,968765.193
119,80,199,Hg,198,968279.932
118,81,199,Tl,198,969877
117,82,199,Pb,198,972916.65
116,83,199,Bi,198,977671.961
115,84,199,Po,198,983666.063
114,85,199,At,198,990532.254
113,86,199,Rn,198,998370.297
112,87,199,Fr,199,7258.147
122,78,200,Pt,199,971440.677
121,79,200,Au,199,970725.647
120,80,200,Hg,199,968326.004
119,81,200,Tl,199,970962.672
118,82,200,Pb,199,971826.675
117,83,200,Bi,199,978131.829
116,84,200,Po,199,981798.604
115,85,200,At,199,990351.264
114,86,200,Rn,199,995699.3
113,87,200,Fr,200,6572.49
123,78,201,Pt,200,974512.868
122,79,201,Au,200,971657.24
121,80,201,Hg,200,970302.268
120,81,201,Tl,200,970818.891
119,82,201,Pb,200,972884.511
118,83,201,Bi,200,977009.036
117,84,201,Po,200,982259.764
116,85,201,At,200,988416.999
115,86,201,Rn,200,995628.335
114,87,201,Fr,201,3860.867
124,78,202,Pt,201,975740
123,79,202,Au,201,973805.838
122,80,202,Hg,201,970643.011
121,81,202,Tl,201,972105.808
120,82,202,Pb,201,972159.133
119,83,202,Bi,201,977742.324
118,84,202,Po,201,980757.541
117,85,202,At,201,988630.236
116,86,202,Rn,201,993263.492
115,87,202,Fr,202,3372.847
114,88,202,Ra,202,9890.686
124,79,203,Au,202,975154.542
123,80,203,Hg,202,972872.484
122,81,203,Tl,202,972344.22
121,82,203,Pb,202,973390.521
120,83,203,Bi,202,976876.001
119,84,203,Po,202,981420.103
118,85,203,At,202,986941.984
117,86,203,Rn,202,993386.687
116,87,203,Fr,203,924.647
115,88,203,Ra,203,9271.619
125,79,204,Au,203,977724
124,80,204,Hg,203,973493.933
123,81,204,Tl,203,973863.522
122,82,204,Pb,203,973043.589
121,83,204,Bi,203,977812.736
120,84,204,Po,203,980318.121
119,85,204,At,203,987251.326
118,86,204,Rn,203,991428.74
117,87,204,Fr,204,653.204
116,88,204,Ra,204,6499.668
126,79,205,Au,204,979870
125,80,205,Hg,204,976073.386
124,81,205,Tl,204,974427.541
123,82,205,Pb,204,974481.755
122,83,205,Bi,204,977389.366
121,84,205,Po,204,981203.322
120,85,205,At,204,986074.483
119,86,205,Rn,204,991718.799
118,87,205,Fr,204,998593.96
117,88,205,Ra,205,6268.57
126,80,206,Hg,205,977514.066
125,81,206,Tl,205,976110.32
124,82,206,Pb,205,974465.278
123,83,206,Bi,205,978499.13
122,84,206,Po,205,980481.099
121,85,206,At,205,986667.036
120,86,206,Rn,205,990214.104
119,87,206,Fr,205,998666.066
118,88,206,Ra,206,3827.27
117,89,206,Ac,206,14504.98
127,80,207,Hg,206,982588.545
126,81,207,Tl,206,977419.429
125,82,207,Pb,206,975896.887
124,83,207,Bi,206,978470.679
123,84,207,Po,206,981593.173
122,85,207,At,206,985783.502
121,86,207,Rn,206,990734.225
120,87,207,Fr,206,996949.414
119,88,207,Ra,207,3798.105
118,89,207,Ac,207,11949.748
128,80,208,Hg,207,985940
127,81,208,Tl,207,982018.7
126,82,208,Pb,207,976652.071
125,83,208,Bi,207,979742.196
124,84,208,Po,207,981245.702
123,85,208,At,207,986589.977
122,86,208,Rn,207,989642.47
121,87,208,Fr,207,997138.783
120,88,208,Ra,208,1839.94
119,89,208,Ac,208,11551.551
129,80,209,Hg,208,991040
128,81,209,Tl,208,985358.952
127,82,209,Pb,208,981090.12
126,83,209,Bi,208,980398.734
125,84,209,Po,208,982430.435
124,85,209,At,208,986173.143
123,86,209,Rn,208,990414.742
122,87,209,Fr,208,995953.555
121,88,209,Ra,209,1991.373
120,89,209,Ac,209,9494.863
119,90,209,Th,209,17715.682
130,80,210,Hg,209,994510
129,81,210,Tl,209,990073.689
128,82,210,Pb,209,984188.527
127,83,210,Bi,209,984120.371
126,84,210,Po,209,982873.673
125,85,210,At,209,987147.71
124,86,210,Rn,209,989696.216
123,87,210,Fr,209,996407.738
122,88,210,Ra,210,494.978
121,89,210,Ac,210,9435.986
120,90,210,Th,210,15075.342
130,81,211,Tl,210,993477
129,82,211,Pb,210,988736.964
128,83,211,Bi,210,987269.46
127,84,211,Po,210,986653.154
126,85,211,At,210,987496.271
125,86,211,Rn,210,990600.523
124,87,211,Fr,210,995536.544
123,88,211,Ra,211,897.987
122,89,211,Ac,211,7734.835
121,90,211,Th,211,14928.413
131,81,212,Tl,211,998228
130,82,212,Pb,211,991897.543
129,83,212,Bi,211,991285.724
128,84,212,Po,211,988867.969
127,85,212,At,211,990744.771
126,86,212,Rn,211,990703.529
125,87,212,Fr,211,996202.244
124,88,212,Ra,211,999794.499
123,89,212,Ac,212,7813.822
122,90,212,Th,212,12980.288
121,91,212,Pa,212,23204.138
131,82,213,Pb,212,996581.499
130,83,213,Bi,212,994384.666
129,84,213,Po,212,992857.28
128,85,213,At,212,992936.646
127,86,213,Rn,212,993882.668
126,87,213,Fr,212,996189.081
125,88,213,Ra,213,383.959
124,89,213,Ac,213,6607.643
123,90,213,Th,213,13010.14
122,91,213,Pa,213,21109.34
132,82,214,Pb,213,999805.408
131,83,214,Bi,213,998711.539
130,84,214,Po,213,995201.35
129,85,214,At,213,996371.733
128,86,214,Rn,213,995362.554
127,87,214,Fr,213,998971.145
126,88,214,Ra,214,107.894
125,89,214,Ac,214,6901.798
124,90,214,Th,214,11499.77
123,91,214,Pa,214,20918.417
133,82,215,Pb,215,4807
132,83,215,Bi,215,1769.776
131,84,215,Po,214,999419.988
130,85,215,At,214,998652.57
129,86,215,Rn,214,998745.483
128,87,215,Fr,215,341.497
127,88,215,Ra,215,2719.834
126,89,215,Ac,215,6453.625
125,90,215,Th,215,11730.33
124,91,215,Pa,215,19185.865
133,83,216,Bi,216,6305.943
132,84,216,Po,216,1915.035
131,85,216,At,216,2423.257
130,86,216,Rn,216,274.37
129,87,216,Fr,216,3197.99
128,88,216,Ra,216,3533.035
127,89,216,Ac,216,8720.075
126,90,216,Th,216,11062.115
125,91,216,Pa,216,19109.564
134,83,217,Bi,217,9470
133,84,217,Po,217,6334.796
132,85,217,At,217,4718.822
131,86,217,Rn,217,3927.675
130,87,217,Fr,217,4631.951
129,88,217,Ra,217,6320.327
128,89,217,Ac,217,9346.914
127,90,217,Th,217,13114.328
126,91,217,Pa,217,18323.986
125,92,217,U,217,24368.791
135,83,218,Bi,218,14316
134,84,218,Po,218,8973.037
133,85,218,At,218,8694.336
132,86,218,Rn,218,5601.256
131,87,218,Fr,218,7578.322
130,88,218,Ra,218,7140.23
129,89,218,Ac,218,11641.453
128,90,218,Th,218,13284.499
127,91,218,Pa,218,20041.889
126,92,218,U,218,23535.671
135,84,219,Po,219,13744
134,85,219,At,219,11161.691
133,86,219,Rn,219,9480.204
132,87,219,Fr,219,9252.149
131,88,219,Ra,219,10085.078
130,89,219,Ac,219,12420.389
129,90,219,Th,219,15536.895
128,91,219,Pa,219,19883.143
127,92,219,U,219,24919.16
136,84,220,Po,220,16602
135,85,220,At,220,15407.682
134,86,220,Rn,220,11393.981
133,87,220,Fr,220,12327.405
132,88,220,Ra,220,11028.384
131,89,220,Ac,220,14762.979
130,90,220,Th,220,15747.762
129,91,220,Pa,220,21875.303
128,92,220,U,220,24723
136,85,221,At,221,18050
135,86,221,Rn,221,15536.782
134,87,221,Fr,221,14254.762
133,88,221,Ra,221,13917.338
132,89,221,Ac,221,15591.248
131,90,221,Th,221,18183.674
130,91,221,Pa,221,21877.983
129,92,221,U,221,26399
137,85,222,At,222,22330
136,86,222,Rn,222,17577.738
135,87,222,Fr,222,17551.73
134,88,222,Ra,222,15374.53
133,89,222,Ac,222,17843.851
132,90,222,Th,222,18468.121
131,91,222,Pa,222,23742
130,92,222,U,222,26086
138,85,223,At,223,25190
137,86,223,Rn,223,21790
136,87,223,Fr,223,19735.857
135,88,223,Ra,223,18502.171
134,89,223,Ac,223,19137.468
133,90,223,Th,223,20811.448
132,91,223,Pa,223,23962.273
131,92,223,U,223,27738.6
138,86,224,Rn,224,24090
137,87,224,Fr,224,23249.951
136,88,224,Ra,224,20211.821
135,89,224,Ac,224,21722.866
134,90,224,Th,224,21466.895
133,91,224,Pa,224,25625.738
132,92,224,U,224,27604.778
139,86,225,Rn,225,28440
138,87,225,Fr,225,25565.414
137,88,225,Ra,225,23611.564
136,89,225,Ac,225,23229.585
135,90,225,Th,225,23951.021
134,91,225,Pa,225,26130.678
133,92,225,U,225,29390.717
132,93,225,Np,225,33913.933
140,86,226,Rn,226,30890
139,87,226,Fr,226,29386.231
138,88,226,Ra,226,25409.823
137,89,226,Ac,226,26098.089
136,90,226,Th,226,24903.069
135,91,226,Pa,226,27947.753
134,92,226,U,226,29338.702
133,93,226,Np,226,35145
141,86,227,Rn,227,35407
140,87,227,Fr,227,31835.938
139,88,227,Ra,227,29177.842
138,89,227,Ac,227,27752.127
137,90,227,Th,227,27704.07
136,91,227,Pa,227,28805.072
135,92,227,U,227,31156.367
134,93,227,Np,227,34956.789
142,86,228,Rn,228,37986
141,87,228,Fr,228,35729
140,88,228,Ra,228,31070.292
139,89,228,Ac,228,31021.112
138,90,228,Th,228,28741.127
137,91,228,Pa,228,31051.376
136,92,228,U,228,31374.006
135,93,228,Np,228,36180
134,94,228,Pu,228,38742.328
142,87,229,Fr,229,38450.228
141,88,229,Ra,229,34957.577
140,89,229,Ac,229,33015.243
139,90,229,Th,229,31762.43
138,91,229,Pa,229,32096.793
137,92,229,U,229,33505.939
136,93,229,Np,229,36263.808
135,94,229,Pu,229,40150.212
143,87,230,Fr,230,42510
142,88,230,Ra,230,37056.394
141,89,230,Ac,230,36294.178
140,90,230,Th,230,33133.843
139,91,230,Pa,230,34540.754
138,92,230,U,230,33939.784
137,93,230,Np,230,37827.597
136,94,230,Pu,230,39649.886
144,87,231,Fr,231,45440
143,88,231,Ra,231,41220
142,89,231,Ac,231,38558.786
141,90,231,Th,231,36304.343
140,91,231,Pa,231,35883.99
139,92,231,U,231,36293.704
138,93,231,Np,231,38245.085
137,94,231,Pu,231,41101.107
136,95,231,Am,231,45560
145,87,232,Fr,232,49772
144,88,232,Ra,232,43638
143,89,232,Ac,232,42027.438
142,90,232,Th,232,38055.325
141,91,232,Pa,232,38591.592
140,92,232,U,232,37156.152
139,93,232,Np,232,40108
138,94,232,Pu,232,41187.097
137,95,232,Am,232,46590
145,88,233,Ra,233,48060
144,89,233,Ac,233,44550
143,90,233,Th,233,41581.843
142,91,233,Pa,233,40247.277
141,92,233,U,233,39635.207
140,93,233,Np,233,40740.546
139,94,233,Pu,233,42997.375
138,95,233,Am,233,46348
137,96,233,Cm,233,50771.232
146,88,234,Ra,234,50704
145,89,234,Ac,234,48420
144,90,234,Th,234,43601.23
143,91,234,Pa,234,43308.058
142,92,234,U,234,40952.088
141,93,234,Np,234,42895.038
140,94,234,Pu,234,43317.076
139,95,234,Am,234,47809
138,96,234,Cm,234,50159.841
146,89,235,Ac,235,51232
145,90,235,Th,235,47510.074
144,91,235,Pa,235,45443.615
143,92,235,U,235,43929.918
142,93,235,Np,235,44063.267
141,94,235,Pu,235,45286.05
140,95,235,Am,235,47946
139,96,235,Cm,235,51434
138,97,235,Bk,235,56580
147,89,236,Ac,236,55296
146,90,236,Th,236,49870
145,91,236,Pa,236,48681.284
144,92,236,U,236,45568.006
143,93,236,Np,236,46569.6
142,94,236,Pu,236,46057.964
141,95,236,Am,236,49579
140,96,236,Cm,236,51413
139,97,236,Bk,236,57330
147,90,237,Th,237,53894
146,91,237,Pa,237,51145.659
145,92,237,U,237,48730.184
144,93,237,Np,237,48173.444
143,94,237,Pu,237,48409.658
142,95,237,Am,237,49996
141,96,237,Cm,237,52901
140,97,237,Bk,237,57003
139,98,237,Cf,237,62070
148,90,238,Th,238,56496
147,91,238,Pa,238,54502.71
146,92,238,U,238,50788.247
145,93,238,Np,238,50946.405
144,94,238,Pu,238,49559.894
143,95,238,Am,238,51984.324
142,96,238,Cm,238,53028.697
141,97,238,Bk,238,58281
140,98,238,Cf,238,61410
148,91,239,Pa,239,57260
147,92,239,U,239,54293.299
146,93,239,Np,239,52939.025
145,94,239,Pu,239,52163.381
144,95,239,Am,239,53024.479
143,96,239,Cm,239,54957
142,97,239,Bk,239,58279
141,98,239,Cf,239,62422
149,91,240,Pa,240,60980
148,92,240,U,240,56591.988
147,93,240,Np,240,56162.182
146,94,240,Pu,240,53813.545
145,95,240,Am,240,55300.179
144,96,240,Cm,240,55529.539
143,97,240,Bk,240,59759
142,98,240,Cf,240,62302
141,99,240,Es,240,68920
149,92,241,U,241,60330
148,93,241,Np,241,58252.431
147,94,241,Pu,241,56851.456
146,95,241,Am,241,56829.144
145,96,241,Cm,241,57653.001
144,97,241,Bk,241,60230
143,98,241,Cf,241,63726
142,99,241,Es,241,68538
150,92,242,U,242,62931
149,93,242,Np,242,61641.18
148,94,242,Pu,242,58742.611
147,95,242,Am,242,59549.159
146,96,242,Cm,242,58835.824
145,97,242,Bk,242,61981
144,98,242,Cf,242,63701.552
143,99,242,Es,242,69745
142,100,242,Fm,242,73430
150,93,243,Np,243,64279
149,94,243,Pu,243,62003.092
148,95,243,Am,243,61381.08
147,96,243,Cm,243,61389.114
146,97,243,Bk,243,63007.572
145,98,243,Cf,243,65427
144,99,243,Es,243,69548
143,100,243,Fm,243,74353
151,93,244,Np,244,67850
150,94,244,Pu,244,64203.907
149,95,244,Am,244,64284.847
148,96,244,Cm,244,62752.578
147,97,244,Bk,244,65180.774
146,98,244,Cf,244,66000.689
145,99,244,Es,244,70883
144,100,244,Fm,244,74084
151,94,245,Pu,245,67747.154
150,95,245,Am,245,66452.114
149,96,245,Cm,245,65491.249
148,97,245,Bk,245,66361.616
147,98,245,Cf,245,68048.612
146,99,245,Es,245,71324
145,100,245,Fm,245,75385
144,101,245,Md,245,80829
152,94,246,Pu,246,70204.627
151,95,246,Am,246,69774.619
150,96,246,Cm,246,67223.662
149,97,246,Bk,246,68672.947
148,98,246,Cf,246,68805.309
147,99,246,Es,246,72896
146,100,246,Fm,246,75299.023
145,101,246,Md,246,81886
153,94,247,Pu,247,74070
152,95,247,Am,247,72093
151,96,247,Cm,247,70353.54
150,97,247,Bk,247,70307.08
149,98,247,Cf,247,71000.589
148,99,247,Es,247,73656
147,100,247,Fm,247,76847
146,101,247,Md,247,81635
153,95,248,Am,248,75752
152,96,248,Cm,248,72348.508
151,97,248,Bk,248,73086
150,98,248,Cf,248,72184.861
149,99,248,Es,248,75471
148,100,248,Fm,248,77194.714
147,101,248,Md,248,82823
146,102,248,No,248,86596
154,95,249,Am,249,78480
153,96,249,Cm,249,75953.413
152,97,249,Bk,249,74986.657
151,98,249,Cf,249,74853.537
150,99,249,Es,249,76411
149,100,249,Fm,249,79034
148,101,249,Md,249,83013
147,102,249,No,249,87833
154,96,250,Cm,250,78356.959
153,97,250,Bk,250,78316.52
152,98,250,Cf,250,76406.066
151,99,250,Es,250,78612
150,100,250,Fm,250,79521.264
149,101,250,Md,250,84420
148,102,250,No,250,87510
155,96,251,Cm,251,82284.605
154,97,251,Bk,251,80760.172
153,98,251,Cf,251,79586.788
152,99,251,Es,251,79992.142
151,100,251,Fm,251,81575.017
150,101,251,Md,251,84839
149,102,251,No,251,89012
148,103,251,Lr,251,94360
156,96,252,Cm,252,84870
155,97,252,Bk,252,84310
154,98,252,Cf,252,81625.846
153,99,252,Es,252,82978.512
152,100,252,Fm,252,82466.855
151,101,252,Md,252,86560
150,102,252,No,252,88976.521
149,103,252,Lr,252,95371
156,97,253,Bk,253,86880
155,98,253,Cf,253,85133.145
154,99,253,Es,253,84824.697
153,100,253,Fm,253,85185.236
152,101,253,Md,253,87280
151,102,253,No,253,90678
150,103,253,Lr,253,95210
149,104,253,Rf,253,100689
157,97,254,Bk,254,90600
156,98,254,Cf,254,87322.909
155,99,254,Es,254,88022.021
154,100,254,Fm,254,86854.22
153,101,254,Md,254,89656
152,102,254,No,254,90955.253
151,103,254,Lr,254,96454
150,104,254,Rf,254,100184
157,98,255,Cf,255,91046
156,99,255,Es,255,90273.122
155,100,255,Fm,255,89962.202
154,101,255,Md,255,91082.705
153,102,255,No,255,93241.131
152,103,255,Lr,255,96681
151,104,255,Rf,255,101340
150,105,255,Db,255,107398
158,98,256,Cf,256,93440
157,99,256,Es,256,93598
156,100,256,Fm,256,91773.117
155,101,256,Md,256,94059.025
154,102,256,No,256,94282.666
153,103,256,Lr,256,98629
152,104,256,Rf,256,101166.194
151,105,256,Db,256,108127
158,99,257,Es,257,95979
157,100,257,Fm,257,95104.724
156,101,257,Md,257,95541.368
155,102,257,No,257,96877.19
154,103,257,Lr,257,99555
153,104,257,Rf,257,102990
152,105,257,Db,257,107722
159,99,258,Es,258,99520
158,100,258,Fm,258,97076
157,101,258,Md,258,98431.319
156,102,258,No,258,98207
155,103,258,Lr,258,101814
154,104,258,Rf,258,103489
153,105,258,Db,258,109231
152,106,258,Sg,258,113168
159,100,259,Fm,259,100595
158,101,259,Md,259,100509
157,102,259,No,259,101031
156,103,259,Lr,259,102901
155,104,259,Rf,259,105637
154,105,259,Db,259,109610
153,106,259,Sg,259,114500
160,100,260,Fm,260,102678
159,101,260,Md,260,103652
158,102,260,No,260,102643
157,103,260,Lr,260,105504
156,104,260,Rf,260,106440
155,105,260,Db,260,111300
154,106,260,Sg,260,114422.071
153,107,260,Bh,260,121970
160,101,261,Md,261,105721
159,102,261,No,261,105749
158,103,261,Lr,261,106883
157,104,261,Rf,261,108766.556
156,105,261,Db,261,112056
155,106,261,Sg,261,116117
154,107,261,Bh,261,121664
161,101,262,Md,262,108865
160,102,262,No,262,107301
159,103,262,Lr,262,109634
158,104,262,Rf,262,109925
157,105,262,Db,262,114084
156,106,262,Sg,262,116398
155,107,262,Bh,262,122892
161,102,263,No,263,110552
160,103,263,Lr,263,111293
159,104,263,Rf,263,112547
158,105,263,Db,263,114988
157,106,263,Sg,263,118322
156,107,263,Bh,263,123035
155,108,263,Hs,263,128558
162,102,264,No,264,112345
161,103,264,Lr,264,114038
160,104,264,Rf,264,113985
159,105,264,Db,264,117404
158,106,264,Sg,264,118931
157,107,264,Bh,264,124604
156,108,264,Hs,264,128394.885
162,103,265,Lr,265,115839
161,104,265,Rf,265,116704
160,105,265,Db,265,118601
159,106,265,Sg,265,121114.693
158,107,265,Bh,265,125147
157,108,265,Hs,265,130085
156,109,265,Mt,265,136151
163,103,266,Lr,266,119305
162,104,266,Rf,266,117956
161,105,266,Db,266,121029
160,106,266,Sg,266,122065
159,107,266,Bh,266,126942
158,108,266,Hs,266,130097
157,109,266,Mt,266,137299
163,104,267,Rf,267,121529
162,105,267,Db,267,122377
161,106,267,Sg,267,124425
160,107,267,Bh,267,127650
159,108,267,Hs,267,131789
158,109,267,Mt,267,137307
157,110,267,Ea,267,144341
164,104,268,Rf,268,123644
163,105,268,Db,268,125445
162,106,268,Sg,268,125606
161,107,268,Bh,268,129755
160,108,268,Hs,268,132162
159,109,268,Mt,268,138728
158,110,268,Ea,268,143795
164,105,269,Db,269,127460
163,106,269,Sg,269,128755
162,107,269,Bh,269,130694
161,108,269,Hs,269,134056
160,109,269,Mt,269,139055
159,110,269,Ea,269,145124
165,105,270,Db,270,130712
164,106,270,Sg,270,130329
163,107,270,Bh,270,133616
162,108,270,Hs,270,134650
161,109,270,Mt,270,140657
160,110,270,Ea,270,144720
165,106,271,Sg,271,133472
164,107,271,Bh,271,135179
163,108,271,Hs,271,137657
162,109,271,Mt,271,141139
161,110,271,Ea,271,146062
166,106,272,Sg,272,135158
165,107,272,Bh,272,138032
164,108,272,Hs,272,139052
163,109,272,Mt,272,143738
162,110,272,Ea,272,146317
161,111,272,Eb,272,153615
167,106,273,Sg,273,138220
166,107,273,Bh,273,139618
165,108,273,Hs,273,141986
164,109,273,Mt,273,144913
163,110,273,Ea,273,148863
162,111,273,Eb,273,153682
167,107,274,Bh,274,142440
166,108,274,Hs,274,143131
165,109,274,Mt,274,147492
164,110,274,Ea,274,149492
163,111,274,Eb,274,155713
168,107,275,Bh,275,144250
167,108,275,Hs,275,145952
166,109,275,Mt,275,148647
165,110,275,Ea,275,152176
164,111,275,Eb,275,156142
168,108,276,Hs,276,147208
167,109,276,Mt,276,151156
166,110,276,Ea,276,153034
165,111,276,Eb,276,158493
169,108,277,Hs,277,149841
168,109,277,Mt,277,152420
167,110,277,Ea,277,155647
166,111,277,Eb,277,159519
165,112,277,Ec,277,163943
169,109,278,Mt,278,154812
168,110,278,Ea,278,156469
167,111,278,Eb,278,161604
166,112,278,Ec,278,164312
170,109,279,Mt,279,156193
169,110,279,Ea,279,158861
168,111,279,Eb,279,162468
167,112,279,Ec,279,166546
170,110,280,Ea,280,159795
169,111,280,Eb,280,164473
168,112,280,Ec,280,167039
171,110,281,Ea,281,162061
170,111,281,Eb,281,165372
169,112,281,Ec,281,169286
171,111,282,Eb,282,167486
170,112,282,Ec,282,169765
172,111,283,Eb,283,168415
171,112,283,Ec,283,171792
170,113,283,Ed,283,176451
172,112,284,Ec,284,172384
171,113,284,Ed,284,178080
173,112,285,Ec,285,174105
172,113,285,Ed,285,178732
171,114,285,Ee,285,183698
173,113,286,Ed,286,180481
172,114,286,Ee,286,183855
174,113,287,Ed,287,181045
173,114,287,Ee,287,185599
172,115,287,Ef,287,191186
174,114,288,Ee,288,185689
173,115,288,Ef,288,192492
175,114,289,Ee,289,187279
174,115,289,Ef,289,192715
173,116,289,Eg,289,198862
175,115,290,Ef,290,194141
174,116,290,Eg,290,198590
176,115,291,Ef,291,194384
175,116,291,Eg,291,200011
174,117,291,Eh,291,206564
176,116,292,Eg,292,199786
175,117,292,Eh,292,207549
175,118,293,Ei,293,214670
